Wot, Wot, Wot, Wot, Wot, Wot, Wot, Wot, Wot, Wot, Wot, Wot, Wot, Wot, Wot, Wot, Wot, Wot, Wot, Wot, Wot, Wot, Wot, Wot, Wot, Wot, Wot, Wot, Wot, Wot, Wot, Wot, Wot, Wot, Wot, Wot, Wot, Wot, Wot, Wot, Wot, Wot, Wot, Wot, Wot, Wot, Wot, Wot, Wot, Wot, Wot, Wot, Wot, Wot
Wot, Wot, Wot, Wot, Wot, Wot, Wot, Wot, Wot, Wot, Wot, Wot, Wot, Wot, Wot, Wot, Wot, Wot, Wot, Wot, Wot, Wot, Wot, Wot, Wot, Wot, Wot, Wot, Wot, Wot, Ds, Wot, Ds, Wot, Ds, Wot, Wot, Wot, Wot, Wot, Wot, Wot, Wot, Wot, Wot, Wot, Wot, Wot, Wot, Wot, Wot, Wot, Wot, Wot
Wot, Wot, Wot, Wot, Wot, Wot, Wot, Wot, Wot, Wot, Wot, Wot, Wot, Wot, Wot, Wot, Wot, Wot, Wot, Wot, Ds, Wot, Ds, Ds, Ds, Ds, Ds, Ds, Ds, Ds, Ch, Ds, Ch, Ds, Ch, Ds, Ds, Ds, Ds, Ds, Ds, Wot, Wot, Wot, Wot, Wot, Wot, Wot, Wot, Wot, Gg, Wot, Gg, Gg
Gg, Wot, Gg, Gg, Gg, Gg, Gg, Wot, Gg, Gg, Wot, Wot, Wot, Wot, Wot, Wot, Wot, Wot, Ds, Ds, Ch, Ds, Ch, Ch, Ch, Ch, Ch, Ch, Ch, Ch, Ww^Ewf, Ch, Gg^Efm, Ch, Ww^Ewf, Ch, Ch, Ch, Ch, Ch, Ch, Ds, Ds, Wot, Wot, Wot, Wot, Wot, Wot, Wot, Gg, Gg, Gg, Gg
Gg, Gg, Gg, Gg, Gg, Gg, Gg, Gg, Gg, Gg, Gg, Wot, Wot, Wot, Wot, Wot, Ds, Ds, Ch, Ch, Rrc, Ch, Rrc, Rrc, Rrc, Rrc, Ch, Gs^Fds, Gg^Fet, Ww, Gg^Efm, Gg^Efm, Kh, Gg^Efm, Gg^Efm, Ww, Gg^Fet, Gs^Fms, Ch, Rrc, Rrc, Ch, Ch, Ds, Ds, Wot, Wot, Wot, Wot, Gg, Gg, Gg, Gg, Gg
Gs^Fms, Gg, Gs^Fms, Gs^Vh, Gg, Gg^Es, Gg, Gg, Gg, Gg, Gg, Wot, Wot, Wot, Wot, Ds, Ch, Ch, Rrc, Rrc, Rrc, Rrc, Rrc, Rrc, Rp^Vhcr, Rrc, Ch, Gs^Fms, Gs^Efm, Gs^Efm, Gg^Efm, Ch, Ch, Ch, Gg^Efm, Gs^Efm, Gs^Efm, Gs^Fms, Ch, Rrc, Rp^Vhcr, Rrc, Rrc, Ch, Ch, Ds, Wot, Wot, Wot, Gg, Gg, Gg, Gg, Gg
Gs^Fms, Gs^Fms, Gs^Fms, Gg, Gg, Gg, Gg, Gg, Gg, Gg, Gg, Wot, Wot, Wot, Wot, Ds, Ch, Rrc, Rp^Vhcr, Rrc, Ch, Ch, Ch, Rrc, Rrc, Rrc, Ch, Gg^Efm, Gg^Efm, Ch, Ch, Ch, Ch, Ch, Ch, Ch, Gg^Efm, Gg^Efm, Ch, Rrc, Rrc, Rrc, Rrc, Rrc, Ch, Ds, Wot, Wot, Gg, Gg, Gg, Gg, Gg, Gg
Gs^Fms, Gs^Fms, Gs^Fms, Gg, Gg, Gg, Gg, Gg, Gg, Gg, Gg, Wot, Wot, Wot, Wot, Ds, Ch, Rrc, Rrc, Rrc, Chr, Kh, Ch, Rrc, Rrc, Rrc, Rrc, Ch, Ch, Rrc, Rrc, Ch, Ch, Ch, Rrc, Rrc, Ch, Ch, Rrc, Rrc, Rrc, Rrc, Rrc, Ch, Ds, Ds, Wot, Wot, Gg, Gg, Gg, Gg, Gg, Gg
Gs^Fms, Gs^Fms, Gg, Gg, Gg, Gg, Gg, Gg, Gg, Gg, Gg, Wot, Wot, Wot, Wot, Ds, Ch, Rrc, Rrc, Rrc, Rrc, Chr, Rrc, Rrc, Rrc, Rp^Vhcr, Rrc, Rrc, Rrc, Rrc, Rrc, Rrc, Rrc, Rrc, Rrc, Rrc, Rp^Vhcr, Rrc, Chr, Ch, Ch, Rrc, Rrc, Ch, Ds, Wot, Wot, Wot, Gg, Gg, Gg, Gs^Vh, Gg, Gg
Gs^Fms, Gg, Gg, Gg, Gg, Gg, Gg, Gg, Gg, Gg, Gg, Wot, Wot, Wot, Wot, Ds, Ds, Ch, Chr, Rrc, Rrc, Rrc, Rrc, Rrc, Rrc, Rrc, Rrc, Rrc, Rrc, Rrc, Khr, Rrc, Rrc, Rrc, Khr, Rrc, Rrc, Rrc, Chr, Kh, Chr, Rrc, Ch, Ch, Ds, Wot, Wot, Gg, Gg, Gg, Gg, Gg, Gg, Gg
Gg, Gg, Gg, Gg, Gg, Gg, Gg, Gg, Rb^Gvs, Gs^Vl, Gg^Wm, Gg, Gg, Wot, Wot, Wot, Wot, Ds, Chr, Rrc, Rrc, Rrc, Rrc, Rrc, Rp^Vhcr, Rrc, Rrc, Rrc, Rrc, Rrc, Rrc, Rrc, Rrc, Rrc, Rrc, Rrc, Rp^Vhcr, Rrc, Rrc, Chr, Rrc, Rrc, Ch, Ds, Wot, Wot, Wot, Gg, Gg^Es, Gg, Gg, Gg, Gs^Fms, Gs^Fms
Gg, Gg, Gg, Gg, Gg, Gg, Rb^Gvs, Rb^Gvs, Rb^Gvs, Rb^Gvs, Gg, Gg, Gg, Gg, Wot, Wot, Wot, Ds, Ds, Chr, Chr, Rrc, Rrc^Ebn, Rrc, Rrc, Rrc, Rrc, Rrc, Rrc, Rrc, Rrc, Rrc, Rrc, Rrc, Rrc, Rrc, Rrc, Rrc, Rrc, Rrc, Rrc, Rrc, Ch, Ds, Wot, Wot, Wot, Gg, Gg, Gg, Gg, Gg, Gs^Fms, Gs^Fms
Gg, Gg, Gs^Vl, Gg, Rb^Gvs, Rb^Gvs, Rb^Gvs, Rb^Gvs, Rb^Gvs, Rb^Gvs, Gg, Gg, Gg^Es, Gg, Gg, Wot, Wot, Wot, Wot, Ds, Ds, Chr, Rrc, Rrc, Rrc, Rrc, Rrc, Rp^Vhcr, Rrc, Rrc, Rp^Vhcr, Rrc, Rrc, Rrc, Rp^Vhcr, Rrc, Rrc, Rrc, Rrc, Rp^Vhcr, Rrc, Ch, Ds, Ds, Wot, Wot, Gg, Gg, Gg, Gg, Gg, Gg, Gs^Fms, Gs^Fms
Gg, Gg, Gg, Rb^Gvs, Rb^Gvs, Rb^Gvs, Rb^Gvs, Rb^Gvs, Gg, Gg, Gg, Gg, Gg^Efm, Gg, Gg, Gg, Wot, Wot, Wot, Wot, Wot^Bsb/, Wot^Bsb/, Ds, Chr, Rrc, Rp^Vhcr, Rrc, Rrc, Rrc, Rrc, Rrc, Rrc, Rrc, Rrc, Rrc, Rrc, Rrc, Rp^Vhcr, Rrc, Rrc, Chr, Chr, Ds, Wot, Wot, Wot, Gg, Gg, Gg, Gg, Gg, Gg, Gg, Gg
Gg, Gg, Gg, Rb^Gvs, Rb^Gvs, Rb^Gvs, Gg^Efm, Gg, Gg^Efm, Gg^Efm, Gg^Efm, Gg^Efm, Gg^Efm, Gg^Efm, Gg^Efm, Gg, Gg, Wot, Wot^Bsb/, Wot^Bsb/, Wot, Wot, Ds, Chr, Chr, Rrc, Chr, Rrc, Rrc, Rp^Vhcr, Rrc, Rrc, Rrc, Rp^Vhcr, Rrc, Rp^Vhcr, Rrc, Rrc, Rrc, Rrc^Ebn, Chr, Ds, Wot, Wot, Wot, Gg, Gg, Gg, Gg, Gg, Gs^Vl, Gg, Gg, Gg
Gs^Fms, Gs^Fms, Gs^Fms, Gg, Gg, Gg, Gg^Efm, Gg^Efm, Gg^Efm, Gg^Efm, Gg^Efm, Gg^Efm, Gg^Efm, Gg^Efm, Gg^Efm, Gg^Efm, Gg, Gg, Wot, Wot, Wot, Wot, Wot, Ds, Ds, Chr, Ds, Chr, Khr, Rrc, Rrc, Rrc^Ebn, Chr, Rrc, Rrc, Rrc, Rrc, Rrc, Chr, Rrc, Wot^Bsb\, Ds, Wot, Wot, Gg, Gg, Gg, Gg, Gg, Gg, Rb^Gvs, Rb^Gvs, Rb^Gvs, Gg
Gs^Fms, Gs^Fms, Gg, Gg, Gg, Gg, Gg, Gg^Efm, Gg, Gg, Gg, Gg^Efm, Gg, Gg^Efm, Gg, Gg, Gg, Gg, Gg, Wot, Wot, Wot, Wot, Wot, Wot, Ds, Wot, Ds, Wot^Bsb/, Rrc, Khr, Chr, Ds, Chr, Chr, Khr, Rrc, Khr, Ds, Ds, Wot, Wot^Bsb\, Wot^Bsb\, Wot, Gg, Gg, Gg, Gg, Rb^Gvs, Rb^Gvs, Rb^Gvs, Rb^Gvs, Rb^Gvs, Gg
Gs^Fms, Gs^Fms, Gg, Gg, Gg, Gg, Gg, Gg, Gg, Gg, Gg, Gg, Wwt, Gg, Wwt, Gg, Wwt, Gg, Wwt^Bw\, Wwt, Wwt, Wot, Wot, Wot, Wot, Wot, Wot^Bsb/, Wot^Bsb/, Wot, Wot, Wot, Ds, Wot, Ds, Ds, Ds, Wot^Bsb|, Ds, Wot, Wot, Wot, Wot, Gg, Gg, Gg, Gg, Gs^Vl, Rb^Gvs, Rb^Gvs, Rb^Gvs, Rb^Gvs, Rb^Gvs, Gg, Gg
Gg, Gg, Gg, Gg, Wwt, Wwt, Wwt, Wwt, Wwt, Wwt, Wwt, Wwt, Wwt, Wwt, Wwt, Wwt, Wwt, Wwt, Wwt, Wwt^Bw\, Wwt^Bw\, Wwt, Gg, Wot, Gg, Wot^Bsb/, Wot, Wot, Wot, Wot, Wot, Wot, Wot, Wot, Wot, Wot, Wot^Bsb|, Wot, Wot, Wot, Wwt, Wwt, Gg^Es, Gg, Gg, Gg, Gg^Wm, Rb^Gvs, Rb^Gvs, Rb^Gvs, Gg, Gg, Gg, Gg
Gg, Gg, Wwt^Bw\, Wwt, Wwt, Wwt, Wwt, Wwt, Wwt, Wwt, Wwt, Wwt, Gg^Es, Wwt, Gg, Wwt, Gg, Wwt, Gg, Wwt, Gg, Gg, Gg, Gg, Gg, Gg, Gg, Gg, Gg, Wot, Wwt, Wot, Wwt, Wot, Wwt, Wot, Gg, Wot, Gg, Wwt, Wwt, Wwt, Wwt^Bw/, Gg, Gg, Gg, Gg, Gg, Gg, Gg, Gg, Gg, Gs^Fms, Gs^Fms
Wwt, Wwt, Wwt, Wwt^Bw\, Gg, Gg, Gg, Gg, Gg, Gg, Gg, Gg, Gg, Gg, Gg, Gg, Gs^Vl, Gg, Gg, Gg, Gg, Gg, Gg, Gg, Gg, Gg, Gs^Vl, Gg^Es, Gg, Gg, Gg, Wwt, Wwt, Wwt, Gg^Es, Gg, Gg, Gg, Gg, Gg, Gg, Wwt^Bw/, Wwt, Wwt, Gg, Gg, Gg, Gg, Gg, Gg, Gs^Fms, Gg, Gs^Fms, Gs^Fms
Wwt, Wwt, Gg, Gg, Gg, Gg, Gg^Efm, Gg^Efm, Gg^Efm, Gg^Efm, Gg^Efm, Gg^Efm, Gg, Gg, Rb^Gvs, Rb^Gvs, Rb^Gvs, Gg^Vwm, Gg, Gg, Gg, Gg, Gg, Gg, Rb^Gvs, Rb^Gvs, Rb^Gvs, Gg^Vwm, Gg, Gg, Gg, Wwt^Bw\, Wwt^Bw\, Gg, Gg, Gg, Gg, Gg, Gg, Gg, Gg, Gg, Wwt, Wwt, Wwt, Gg, Gg, Gg, Gg, Gg, Gg, Gs^Fms, Gs^Fms, Gs^Fms
Gg, Gg, Gg, Gg, Gs^Vh, Gg, Gg^Efm, Gg^Efm, Gg^Efm, Gg^Efm, Gg, Gg, Rb^Gvs, Rb^Gvs, Rb^Gvs, Rb^Gvs, Rb^Gvs, Gg, Gg, Gg, Gg, Gg, Rb^Gvs, Rb^Gvs, Rb^Gvs, Rb^Gvs, Rb^Gvs, Gs^Vl, Gg, Gg, Wwt, Wwt, Wwt, Gg, Gg, Gg, Gg, Gg, Gg, Gg, Gg, Gg, Gg^Es, Wwt, Wwt, Wwt, Wwt, Gg, Gg, Gg, Gs^Vh, Gg, Gg, Gs^Fms
Gg, Gg, Gg, Gg, Gg, Gg^Efm, Gg^Efm, Gg^Efm, Gg, Gg, Rb^Gvs, Rb^Gvs, Rb^Gvs, Rb^Gvs, Rb^Gvs, Rb^Gvs, Gg, Gg, Gg, Gg, Rb^Gvs, Rb^Gvs, Rb^Gvs, Rb^Gvs, Rb^Gvs, Rb^Gvs, Gg, Gg, Gg, Gg, Wwt, Wwt, Gg, Gg, Gg, Gg, Gg, Gg, Gg, Gg, Gs^Vl, Gg, Gg, Gg, Gg, Wwt, Wwt, Wwt, Gg, Gg, Gg, Gg, Gg, Gg
Gg, Gg, Gg, Gg, Gg, Gg^Efm, Gg, Gg, Rb^Gvs, Rb^Gvs, Rb^Gvs, Rb^Gvs, Rb^Gvs, Rb^Gvs, Gg, Gg, Gg, Gg, Gg, Rb^Gvs, Rb^Gvs, Rb^Gvs, Rb^Gvs, Rb^Gvs, Gg, Gg, Gg, Gg, Wwt, Wwt, Wwt, Wwt, Gg, Gg, Gg^Es, Gg, Gg, Gg, Rb^Gvs, Rb^Gvs, Rb^Gvs, Gg^Vwm, Gg, Gg, Gg, Gg, Wwt, Wwt, Wwt, Gg, Gg, Gg, Gg, Gg
Gs^Fms, Gg, Gs^Fms, Gg, Gg, Gg, Gg, Gs^Vl, Rb^Gvs, Rb^Gvs, Rb^Gvs, Rb^Gvs, Gg, Gg, Gg, Gg, Gg, Gg, Gg, Rb^Gvs, Rb^Gvs, Rb^Gvs, Gg, Gg, Gg, Gg, Gg, Gg, Wwt, Wwt, Gg, Gg, Gg, Gg, Gg, Gg, Rb^Gvs, Rb^Gvs, Rb^Gvs, Rb^Gvs, Rb^Gvs, Gg, Gg, Gg, Gg, Gg, Gg, Wwt, Wwt, Wwt, Wwt^Bw/, Gg, Gg, Gg
Gs^Fms, Gs^Fms, Gs^Fms, Gg, Gg, Gg, Gg, Gg, Gg, Rb^Gvs, Gg, Gg, Gg^Efm, Gg, Gg, Gg, Gg^Efm, Gg, Gg, Gg, Gg, Gg, Gg, Gg, Gg, Gg, Wwt, Wwt, Wwt, Wwt, Gg, Gg, Gg, Gg, Rb^Gvs, Rb^Gvs, Rb^Gvs, Rb^Gvs, Rb^Gvs, Rb^Gvs, Gg, Gg, Gg, Gg, Gg, Gg, Gg^Es, Gg, Gg, Wwt^Bw/, Wwt, Wwt, Wwt, Gg
Gs^Fms, Gs^Fms, Gs^Fms, Gg, Gg, Gg, Gg, Gg, Gg, Gg, Gg^Efm, Gg^Efm, Gg^Efm, Gg^Efm, Gg^Efm, Gg^Efm, Gg^Efm, Gg^Efm, Gg, Gg^Es, Gg, Gg, Gg, Gg, Wwt, Wwt^Bw\, Wwt^Bw\, Wwt, Gg, Gg, Gg, Gg, Gg, Rb^Gvs, Rb^Gvs, Rb^Gvs, Rb^Gvs, Rb^Gvs, Gg, Gg, Gg, Gg, Gg, Gg, Gg, Gg, Gg, Gg, Gg, Gg, Gg, Wwt, Wwt, Wwt
Gs^Fms, Gs^Fms, Gs^Fms, Gg, Gg, Gg, Gg, Gg, Gg^Efm, Gg^Efm, Gg^Efm, Gg^Efm, Gg^Efm, Gg^Efm, Gg^Efm, Gg^Efm, Gg^Efm, Gg^Efm, Gg, Gg, Gg, Gg, Wwt, Wwt, Wwt, Wwt, Gg, Gg, Gg, Gg, Gg, Gg, Gg, Rb^Gvs, Rb^Gvs, Rb^Gvs, Gg, Gg, Gg, Gg, Gg, Gg, Gs^Vl, Gg, Gg, Gg, Gg, Gg, Gg, Gg, Gg, Wwt, Wwt, Wwt
Gs^Fms, Gs^Fms, Gg, Gg, Gg, Gs^Vh, Gg, Gg, Gg^Efm, Gg^Efm, Gg^Efm, Gg^Efm, Gg^Efm, Gg^Efm, Gg^Efm, Gg^Efm, Gg, Gg, Gg, Gg, Wwt, Wwt, Wwt, Wwt, Gg^Es, Gg, Gg, Gg, Gg^Efm, Gg, Gg, Gg, Gg, Gg, Gg, Gs^Vl, Gg, Gg, Gg, Gg, Rb^Gvs, Rb^Gvs, Rb^Gvs, Gg^Vwm, Gg, Gg, Gg, Gg, Gg, Gg, Gg, Wwt, Wwt, Wwt
Gs^Fms, Gs^Fms, Gg, Gg, Gg, Gg, Gg, Gg, Gg, Gg^Efm, Gg^Efm, Gg^Efm, Gg^Efm, Gg^Efm, Gg, Gg, Gg, Gg, Gg, Gg, Wwt, Wwt, Gg, Gg, Gg, Gg, Gg, Gg^Efm, Gg^Efm, Gg^Efm, Gg^Efm, Gg, Gg, Gg, Gg, Gg, Gg, Gg, Rb^Gvs, Rb^Gvs, Rb^Gvs, Rb^Gvs, Rb^Gvs, Gg, Gg, Gg, Gg, Gg, Gg, Gg, Gg, Wwt, Wwt, Wwt
Gs^Fms, Gg, Gg, Gg, Gg, Gg, Gg, Gg, Gg, Gg, Gg, Gg, Gg, Gg, Wwt, Gg, Wwt, Gg, Wwt, Wwt, Wwt, Wwt, Gg, Gg, Gg, Gg, Gg, Gg^Efm, Gg^Efm, Gg^Efm, Gg^Efm, Gg^Efm, Gg, Gg, Gs^Vl, Gg, Rb^Gvs, Rb^Gvs, Rb^Gvs, Rb^Gvs, Rb^Gvs, Rb^Gvs, Gg^Es, Gg, Gg, Gg, Gg, Gg, Gg, Gg, Wwt, Wwt, Wwt, Wwt
Gg, Gg, Gg, Gg, Gg, Gg, Gg, Gg, Gg, Gg, Wwt, Gg, Wwt, Wwt, Wwt, Wwt, Wwt, Wwt, Wwt, Wwt, Gg, Gg, Gg, Gs^Vh, Gg, Gg, Gg, Gg^Efm, Gg^Efm, Gg^Efm, Gg^Efm, Gg^Efm, Gg, Gg, Gg, Rb^Gvs, Rb^Gvs, Rb^Gvs, Rb^Gvs, Rb^Gvs, Gg, Gg, Gg, Gg, Gg, Gs^Vh, Gg^Efm, Gg, Ch, Wwt, Wwt, Wwt, Wwt, Wwt
Gg, Gg, Gg, Gg, Gg, Gg, Wwt, Gg, Wwt^Bw\, Wwt, Wwt, Wwt, Wwt, Wwt, Gg, Wwt, Ch, Kh, Ch, Ch, Gg, Gg, Gg, Gg, Gg, Gg, Gg, Gg^Efm, Gg^Efm, Gg^Efm, Gg^Efm, Gg^Efm, Gg^Efm, Gg, Gg, Rb^Gvs, Rb^Gvs, Rb^Gvs, Gg, Gg, Gg, Gg, Gg, Gg, Gg, Gg^Efm, Gg, Gg, Ch, Kh, Ch, Wwt, Wwt, Wwt
Gg, Gg, Wwt, Gg, Wwt, Wwt, Wwt, Wwt, Wwt, Wwt^Bw\, Gg, Gg, Gg^Efm, Gg, Gg^Efm, Gg, Gg, Ch, Gg, Gg, Gg^Efm, Gg^Efm, Gg^Efm, Gg, Gg, Gg, Gg, Gg, Gg^Efm, Gg^Efm, Gg^Efm, Gg^Efm, Gg^Efm, Gg, Gg, Gg, Gg, Gg, Gg, Gg, Gg, Gg, Gg, Gg, Gg, Gg, Gg, Gg, Gg, Ch, Gg, Gg, Gg, Wwt
Wwt, Wwt, Wwt, Wwt, Wwt, Wwt, Gg, Wwt, Gg, Gg, Gg^Efm, Gg^Efm, Gg^Efm, Gg^Efm, Gs^Vh, Gg^Efm, Gg^Efm, Gg, Gg, Gg, Gg^Efm, Gs^Vh, Gg^Efm, Gg^Efm, Gg, Gg, Gg, Gg, Gg, Gg^Efm, Gg^Es, Gg^Efm, Gg, Gg, Gg, Gg^Es, Gg, Gg, Gg, Gg, Gg, Gg, Gg, Gg, Gs^Fms, Gg^Fet, Gg, Gg, Gg, Gg, Gg^Efm, Gg^Efm, Gg^Efm, Gg
Wwt, Wwt, Gg, Wwt, Gg, Gg, Gg, Gg, Gg^Efm, Gg^Efm, Gg^Efm, Gg^Efm, Gg^Efm, Gg^Efm, Gg^Efm, Gg^Efm, Gg, Gg, Gg^Es, Gg, Gg, Gg^Efm, Gg^Efm, Gg^Efm, Gg, Gg, Gg, Gg, Gg, Gg, Gg, Gg, Gg, Gg, Gg, Gg, Gg, Gg, Gg, Gs^Fms, Gs^Fms, Gg, Gs^Fms, Gs^Fms, Gg, Gg, Gs^Fms, Gg, Gs^Fms, Gg, Gg^Efm, Gs^Vh, Gg^Efm, Gg
Gs^Fms, Md, Gg, Gg, Gg, Gg, Gg, Gg, Gg^Efm, Gg^Efm, Gg^Efm, Gg^Efm, Gg^Efm, Gg^Efm, Gg, Gg, Gg, Gg, Gs^Fms, Gg, Gg, Gg, Gg, Gg, Gg, Gg^Fet, Gg, Gg, Gs^Fms, Gg, Gg, Gg, Gg, Gg, Gg, Gg, Gg, Gg, Gg, Gg, Gs^Fms, Gs^Fms, Gs^Fms, Gs^Fms, Gs^Fms, Gs^Fms, Gs^Fms, Gs^Fms, Gs^Fms, Gs^Fms, Gg^Efm, Gg^Efm, Md, Md
Gs^Fms, Md, Gg, Gg, Gg, Gg, Gg^Vwm, Gg, Gg, Gg^Efm, Gg, Gg^Efm, Gs^Efm, Gg^Efm, Gs^Fms, Gs^Fms, Gs^Fms, Gs^Fms, Gg^Vwm, Gg, Gg, Gg, Gs^Fms, Gg, Gs^Fms, Gs^Fms, Gs^Fms, Gs^Fms, Gs^Fms, Gg, Gg, Gg, Gs^Vh, Gg, Gg, Gg^Vwm, Gg, Gg, Gg, Gs^Fms, Gg, Gg, Gg, Gs^Fms, Gs^Fms, Gs^Fms, Gg^Efm, Gg^Efm, Gs^Vh, Gg^Efm, Gg, Md, Gs^Fms, Gs^Fms
Gs^Fms, Md, Md, Gg, Gg, Gg, Gg, Gg, Gg, Gg, Gg, Gg, Gg, Gs^Fms, Gg, Gs^Fms, Gs^Fms, Gg, Gg, Gg, Gg, Gg, Gs^Fms, Gs^Fms, Gg, Gs^Fms, Gs^Fms, Gg, Gs^Fms, Gs^Fms, Gg, Gg, Gg, Gg, Gg, Gg, Gg, Gg, Gg, Gg, Gg, Gg^Efm, Gg^Efm, Gg^Efm, Gg^Efm, Gg, Gg, Gg^Efm, Gg^Efm, Gg^Efm, Md, Md, Gs^Fms, Gs^Fms
Gs^Fms, Md, Md, Gg, Gg, Gg, Gg, Gg, Gg, Gg, Gg, Gg, Gg, Gg, Gg, Gs^Fms, Gs^Fms, Gs^Fms, Gs^Fms, Gs^Fms, Gg, Gs^Fms, Gs^Fms, Gg, Gg^Es, Gg, Gg, Gs^Fms, Gs^Fms, Gs^Fms, Gs^Fms, Gg, Gs^Fms, Gg, Gg, Gg, Gg, Gs^Fms, Gg, Gg, Gg, Gg^Efm, Gg^Efm, Gg^Efm, Gg^Efm, Gg, Gg, Gg, Gg, Md, Gs^Fms, Gs^Fms, Gs^Fms, Gs^Fms
Gs^Fms, Gs^Fms, Md, Gg, Gg, Gg, Gg^Efm, Gg, Gg^Fet, Gs^Fms, Gs^Fms, Gg, Gs^Fms, Gg, Gg, Gg, Gg, Gs^Fms, Gg, Gg, Gs^Fms, Gs^Fms, Gg, Gg, Gg, Gg, Gg^Fet, Gg, Gg, Gs^Fms, Gs^Fms, Gs^Fms, Gg, Gg, Gs^Fms, Gg, Gs^Fms, Gs^Fms, Gs^Fms, Gg, Gs^Fms, Gg^Efm, Gg^Efm, Gg^Efm, Gg, Gg, Gg, Gg, Gg, Md, Gg, Gs^Fms, Gs^Fms, Gs^Fms
Gs^Fms, Gs^Fms, Gs^Fms, Md, Gg, Gg^Efm, Gg^Efm, Gg^Efm, Gg^Efm, Gg^Efm, Gg^Efm, Gs^Fms, Gs^Fms, Gg, Gg, Gg, Gg, Gg, Gg, Gg, Gs^Fms, Gg, Gg^Efm, Gg^Efm, Gg^Efm, Gg, Gg, Gg, Gg, Gg, Gg, Gg, Gs^Fms, Gs^Fms, Gs^Fms, Gs^Fms, Gg, Gg, Gs^Fms, Gs^Fms, Gs^Fms, Gs^Fms, Gs^Fms, Gg, Gs^Fms, Gg, Gg, Gg, Gg^Efm, Gg, Gg, Gg, Gg, Gs^Fms
Gs^Fms, Gs^Fms, Gs^Fms, Md, Gg, Gg^Efm, Gg^Efm, Gg^Efm, Gg^Efm, Gg^Efm, Gs^Vh, Gg^Efm, Gs^Fms, Gs^Fms, Gs^Fms, Gg, Gs^Fms, Gs^Fms, Gs^Fms, Gg, Gg, Gs^Efm, Gg^Efm, Gg^Efm, Gg^Efm, Gg^Efm, Gg^Efm, Gg, Gg, Gs^Fms, Gs^Fms, Gs^Fms, Gs^Fms, Gg, Gs^Fms, Gs^Fms, Gg, Gg, Gs^Fms, Gs^Fms, Gs^Fms, Gs^Fms, Gg, Gs^Fms, Gs^Fms, Gg, Gg, Gg^Vwm, Gs^Vh, Gg^Efm, Gg, Gg^Fet, Gg, Gg
Gs^Fms, Gs^Fms, Gs^Fms, Md, Gg, Gg^Efm, Gg^Efm, Gg^Efm, Gg^Efm, Gg^Efm, Gs^Fms, Gs^Fms, Gg, Gg, Gg, Gg, Gg^Fet, Gg, Gs^Fms, Gg, Gs^Fms, Gg^Efm, Gg^Efm, Gg^Efm, Gg^Efm, Gg^Efm, Gg^Efm, Gs^Vh, Gg, Gg, Gs^Fms, Gg, Gg, Gs^Fms, Gs^Fms, Gs^Fms, Gg, Gg^Fet, Gs^Fms, Gg, Gg^Efm, Gg, Gg^Efm, Gs^Fms, Gs^Fms, Gs^Fms, Gg, Gg^Efm, Gg^Efm, Gg^Efm, Gg, Gg, Gs^Fms, Gg
Gs^Fms, Gs^Fms, Gs^Fms, Md, Gg, Gg, Gg, Gg^Efm, Gs^Fms, Gs^Fms, Gg, Gg, Gg, Gg, Gg, Gg, Gs^Fms, Gs^Fms, Gg, Gg, Gg, Gs^Fms, Gs^Fms, Gs^Fms, Gs^Fms, Gg^Efm, Gg, Gg, Gg, Gs^Fms, Gs^Fms, Gg, Gs^Fms, Gs^Fms, Gs^Fms, Gs^Fms, Gg, Gg, Gg, Gs^Fms, Gg^Efm, Gs^Vh, Gg^Efm, Gs^Fms, Gg, Gg, Gg, Gg, Gg, Gg, Gg, Gs^Fms, Gs^Fms, Gs^Fms
Gs^Fms, Gs^Fms, Gg, Gg, Gg, Gg, Gg, Gs^Fms, Gs^Fms, Gs^Fms, Gg^Efm, Gg, Gg, Gg, Gs^Fms, Gs^Fms, Gs^Fms, Gg, Gg, Gg, Gg, Gg, Gg, Gg, Gg, Gs^Fms, Gs^Fms, Gg, Gs^Fms, Gs^Fms, Gs^Fms, Gg, Gg, Gs^Fms, Gs^Fms, Gg, Gs^Fms, Gg, Gg, Gg, Gs^Fms, Gg^Efm, Gg, Gg, Gg, Gg, Gg, Gg, Gg, Gg, Gs^Fms, Gs^Fms, Gg^Ve, Gs^Fms
Gg, Gg, Gg, Gg^Es, Gg^Fet, Gg, Gg, Gs^Fms, Gg^Efm, Gs^Vh, Gg^Efm, Gg, Gg, Gg, Gg, Gg, Gg, Gg, Gg, Gg, Gg, Gg, Gg, Gg, Gg, Gg, Gg, Gg, Gg, Gs^Fms, Gs^Fms, Gg^Fet, Gg, Gg, Gg, Gs^Fms, Gs^Fms, Gs^Fms, Gs^Fms, Gs^Fms, Gs^Fms, Gg, Gg, Gg^Ve, Gg, Gg, Gg^Fet, Gg, Gg, Gs^Fms, Gg, Gg^Efm, Gs^Fms, Gs^Fms
Gg, Gg, Gg, Gg, Gg, Gg, Hh, Gs^Fms, Gg, Gg^Efm, Gg, Gg, Gg, Gg, Gg, Gg, Hh, Gg, Hh, Gg, Gg, Gg^Es, Gg, Gg, Gg, Gg, Gg, Gg, Gg, Gs^Fms, Gs^Fms, Gg, Gg, Gg, Gg, Gs^Fms, Gg, Gs^Fms, Gg, Gs^Fms, Gg, Gs^Fms, Gg, Gg, Gg, Gg, Gg, Gg, Gg, Gg, Gg, Gs^Fms, Gs^Fms, Gs^Fms
Gg, Gg, Hh, Hh, Hh, Hh, Mm, Hh, Hh, Hh, Hh, Gg, Hh, Hh, Hh, Hh, Mm, Hh, Mm, Hh, Hh, Gg, Gg, Gg, Gs^Fms, Gg, Gg, Gg, Gg, Gs^Fms, Gs^Fms, Gg, Gg, Gg, Gg, Gg, Gg, Gg, Gg, Gg, Hh, Hh, Hh, Gg, Hh, Gg, Hh, Hh, Hh, Gg, Gg, Gg, Gg, Gs^Fms
Hh, Hh, Ms^Xm, Mm, Mm, Mm, Ms^Xm, Ms^Xm, Ms^Xm, Mm, Mm, Hh, Mm, Mm, Mm, Mm, Ms^Xm, Mm, Ms^Xm, Mm, Mm, Hh, Hh, Gg, Gg, Gs^Fms, Gg, Gg, Gg, Gg, Gg, Gg, Gg, Gg, Gg, Gs^Fms, Gg, Gg, Gg, Gg^Es, Mm, Mm, Mm, Hh, Mm, Hh, Mm, Mm, Mm, Hh, Hh, Hh, Hh, Gg
Hh, Mm, Ms^Xm, Ms^Xm, Ms^Xm, Ms^Xm, Gs^Fms, Ms^Xm, Ms^Xm, Ms^Xm, Ms^Xm, Ms^Xm, Ms^Xm, Ms^Xm, Ms^Xm, Ms^Xm, Gs^Fms, Ms^Xm, Gs^Fms, Ms^Xm, Ms^Xm, Mm, Hh, Gg, Gg, Gg, Gg, Gg, Gg, Gs^Fms, Gs^Fms, Gs^Fms, Gs^Fms, Gg, Gg, Gg, Gg, Gg, Gs^Fms, Gg, Ms^Xm, Ms^Xm, Ms^Xm, Mm, Ms^Xm, Mm, Ms^Xm, Ms^Xm, Ms^Xm, Ms^Xm, Mm, Mm, Mm, Hh
Md^Xm, Mm, Ms^Xm, Gs^Fms, Gs^Fms, Gs^Fms, Gs^Fms, Gs^Fms, Gs^Fms, Gs^Fms, Gs^Fms, Ms^Xm, Gs^Fms, Gs^Fms, Gs^Fms, Hh, Gs^Fms, Gs^Fms, Gs^Fms, Gs^Fms, Ms^Xm, Mm, Mm, Hh, Gs^Fms, Gs^Fms, Gg, Gg, Gg, Gg, Gs^Fms, Gg, Gs^Fms, Gs^Fms, Gs^Fms, Gg, Gg, Gs^Fms, Gs^Fms, Kvr, Gg^Ve, Gs^Fms, Gs^Fms, Ms^Xm, Gs^Fms, Ms^Xm, Gs^Fms, Gs^Fms, Gs^Fms, Ms^Xm, Ms^Xm, Ms^Xm, Ms^Xm, Md^Xm
Gs^Fms, Mm, Ms^Xm, Gs^Fms, Gs^Fms, Gg^Ve, Gs^Fms, Gs^Fms, Gs^Fms, Hh, Gs^Fms, Gs^Fms, Gs^Fms, Gs^Fms, Gs^Fms, Gs^Fms, Gs^Fms, Gs^Fms, Gs^Fms, Gs^Fms, Gs^Fms, Ms^Xm, Kvr, Gs^Fms, Gs^Fms, Gs^Fms, Cvr, Cvr, Cvr, Gs^Fms, Cvr, Gg^Ve, Cvr, Gs^Fms, Cvr, Cvr, Cvr, Gs^Fms, Gs^Fms, Gs^Fms, Gs^Fms, Gg, Gg, Gg, Gg, Hh, Gg, Gg, Gg^Ve, Gs^Fms, Hh, Gs^Fms, Gs^Fms, Ms^Xm
Gs^Fms, Ms^Xm, Gs^Fms, Gs^Fms, Gs^Fms, Gs^Fms, Gs^Fms, Gs^Fms, Gg^Es, Gg, Gs^Fms, Gg^Ve, Gs^Fms, Gs^Fms, Gg, Gg, Gg, Gg^Fet, Gg, Gs^Fms, Gs^Fms, Gs^Fms, Gs^Fms, Gs^Fms, Gs^Fms, Gs^Fms, Rp, Kvr, Rp, Cvr, Rp, Rp, Rp, Cvr, Rp, Kvr, Rp, Gs^Fms, Gg, Gg, Gg, Gg^Fet, Gs^Fms, Gs^Fms, Gs^Fms, Gg, Gs^Fms, Gs^Fms, Gs^Fms, Gs^Fms, Gs^Fms, Gs^Fms, Gs^Fms, Gs^Fms
Gs^Fms, Gs^Fms, Gs^Fms, Gs^Fms, Gs^Fms, Cvr, Gs^Fms, Gs^Fms, Gg, Gg, Gg, Gs^Fms, Gs^Fms, Gs^Fms, Gg, Gg, Gg, Gg, Gs^Fms, Gs^Fms, Gs^Fms, Gs^Fms, Gg^Ve, Gs^Fms, Gg, Cvr, Rp, Rp, Rp, Rp, Rp, Rp, Rp, Rp, Rp, Rp, Rp, Cvr, Gg, Gg, Gg, Gg, Gs^Fms, Gs^Fms, Gs^Fms, Cvr, Gs^Fms, Gs^Fms, Gs^Fms, Gg, Gg, Gg, Gs^Fms, Gs^Fms
Gs^Fms, Gs^Fms, Gs^Fms, Gs^Fms, Gs^Fms, Gs^Fms, Gs^Fms, Gs^Fms, Gg, Gg, Gs^Fms, Gg, Gg, Gg, Gg, Gg, Gg, Gs^Fms, Gs^Fms, Gs^Fms, Gs^Fms, Gg, Gg, Gg, Gg, Cvr, Cvr, Cvr, Cvr, Cvr, Cvr, Rp, Cvr, Cvr, Cvr, Cvr, Cvr, Cvr, Gg, Gg, Gg, Gg, Gs^Fms, Gs^Fms, Gs^Fms, Gs^Fms, Gs^Fms, Gs^Fms, Gs^Fms, Gg, Gg, Gg, Gg, Gg
Gg, Gs^Fms, Gs^Fms, Gs^Fms, Gs^Fms, Gs^Fms, Gs^Fms, Gs^Fms, Gs^Fms, Gs^Fms, Gs^Fms, Gg, Gs^Fms, Gs^Fms, Gs^Fms, Gg, Gs^Fms, Gg, Gg, Gs^Fms, Gg, Gg, Gg, Gg^Fet, Gg, Gg, Gg, Gg, Gg, Gg, Gg, Rp, Gg, Gg, Gs^Fms, Gs^Fms, Gs^Fms, Gs^Fms, Gs^Fms, Gg^Ve, Gs^Fms, Gg^Fet, Gs^Fms, Gs^Fms, Gg, Gs^Fms, Gs^Fms, Gs^Fms, Gg, Gg, Gg, Gg, Gg, Gg
Gg, Gg, Gs^Fms, Gg, Gg^Ve, Gs^Fms, Gs^Fms, Gs^Fms, Gs^Fms, Gs^Fms, Gs^Fms, Gg, Gs^Fms, Gs^Fms, Gs^Fms, Gs^Fms, Gs^Fms, Gs^Fms, Gs^Fms, Gg, Gs^Fms, Gg, Gg, Gg, Gs^Fms, Gg, Gg, Gg, Gg, Gg, Gs^Fms, Gg^Ve, Gs^Fms, Gs^Fms, Gs^Fms, Gg, Gs^Fms, Gs^Fms, Gs^Fms, Gs^Fms, Gs^Fms, Gs^Fms, Gs^Fms, Gg, Gg, Gg, Gg, Gg, Gg, Gg, Gg, Gg, Gg, Gg
Gg, Gg, Gs^Fms, Gg, Gg, Gs^Fms, Gs^Fms, Gs^Fms, Gg, Gs^Fms, Gs^Fms, Gg, Gs^Fms, Gs^Fms, Gs^Fms, Gs^Fms, Gs^Fms, Gg^Ve, Gs^Fms, Gs^Fms, Gs^Fms, Gs^Fms, Gg, Gs^Fms, Gs^Fms, Gs^Fms, Gs^Fms, Gg, Gg, Gg, Gs^Fms, Gs^Fms, Gs^Fms, Gs^Fms, Gs^Fms, Gs^Fms, Gs^Fms, Gs^Fms, Gs^Fms, Gs^Fms, Gg, Gg, Gs^Fms, Gg, Gg, Gg, Gg, Gg, Gs^Fms, Gg, Gg, Gg, Gg, Gg
Gg, Gg, Gg, Gg, Gg, Gg, Gg, Gs^Fms, Gg, Gg, Gg, Gg, Gs^Fms, Gs^Fms, Gg, Gs^Fms, Gg, Gs^Fms, Gs^Fms, Gs^Fms, Gs^Fms, Gs^Fms, Gs^Fms, Gs^Fms, Gs^Fms, Gs^Fms, Gs^Fms, Gg, Gg, Gs^Fms, Gg, Gs^Fms, Gs^Fds, Gs^Fds, Gs^Fds, Gs^Fms, Gs^Fms, Gs^Fms, Gg, Gg, Gs^Fms, Gs^Fms, Gs^Fms, Gs^Fms, Gg, Gg, Gg, Gs^Fms, Gs^Fms, Gs^Fms, Gs^Fms, Gg, Gg, Gg
Gg, Gg, Gg, Gg, Gg, Gg, Gg^Fet, Gg, Gs^Fms, Gs^Fms, Gs^Fms, Gg, Gg, Gg, Gg, Gg, Gg, Gs^Fms, Gg, Gs^Fms, Gg, Gs^Fms, Gg, Gs^Fms, Gg, Gs^Fms, Gg, Gg, Gg, Gs^Fms, Gg, Gg, Gs^Fds, Gs^Fds, Gs^Fms, Gs^Fms, Gs^Fds, Gs^Fms, Gg, Gs^Fms, Gg, Gs^Fms, Gs^Fms, Gs^Fms, Gg, Gg, Gs^Fms, Gg, Gg, Gg^Ve, Gs^Fms, Gg, Gg, Gg
Gs^Fms, Gs^Fds, Gs^Fms, Gg, Gg, Gg, Gg, Gg, Gg, Gg, Gg, Gg, Gg, Gg, Gs^Fms, Gg, Gg, Gs^Fms, Gs^Fms, Gg, Gg, Gg, Gg, Gg, Gs^Fms, Gg, Gg, Gg, Gg, Gs^Fds, Gs^Fds, Gg, Gg, Gs^Fds, Gs^Fds, Gs^Fms, Gs^Fds, Gg, Gg, Gg, Gg, Gg, Gg, Gg, Gg, Gs^Fms, Gg, Gs^Fms, Gg, Gs^Fms, Gg, Gg, Gs^Fds, Gg
Gll^Fp, Gll^Fp, Gll^Fp, Gg, Gs^Fms, Gs^Fms, Gs^Fms, Gg, Gs^Fds, Gg, Gg, Gg, Gg, Gg, Gg, Gg, Gs^Fms, Gg, Gg, Gg, Gs^Fds, Gg, Gg, Gg, Gg, Gg, Gg, Gg, Gs^Fds, Gs^Fds, Gg^Fet, Gg, Gg, Gs^Fds, Gs^Fds, Gs^Fms, Gs^Fms, Gg, Gg, Gs^Fms, Gg, Gg, Gs^Fds, Gg, Gg^Es, Gg, Gs^Fds, Gs^Fms, Gs^Fds, Gs^Fds, Gs^Fds, Gs^Fds, Gs^Fds, Gs^Fds
Gll^Fp, Gll^Fp, Gll^Fp, Gg, Gll^Fp, Gs^Fms, Gs^Fms, Gs^Fds, Gs^Fds, Gs^Fms, Gs^Fds, Gg, Gs^Fds, Gg, Gs^Fms, Gs^Fds, Gs^Fds, Gg^Ve, Gg, Gs^Fms, Gs^Fms, Gs^Fms, Gs^Fds, Gg, Gs^Fds, Gg, Gg, Gg, Gs^Fms, Gs^Fms, Gs^Fds, Gs^Fds, Gg, Gg, Gs^Fds, Gs^Fds, Gg, Gg, Gs^Fds, Gs^Fds, Gs^Fms, Gs^Fds, Gs^Fds, Gs^Fds, Gs^Fds, Gg, Gg^Ve, Gs^Fds, Gs^Fms, Gs^Fms, Gs^Fms, Gs^Fds, Gs^Fds, Gs^Fds
Ms^Xm, Gll^Fp, Gll^Fp, Gg, Gll^Fp, Gs^Fms, Gs^Fms, Gs^Fms, Gs^Fms, Gg^Fet, Gg, Gg, Gs^Fms, Gs^Fms, Gs^Fms, Gs^Fds, Gs^Fms, Gs^Fms, Gg, Gs^Fds, Gs^Fds, Gg, Gs^Fds, Gs^Fds, Gg, Gg, Gg, Gs^Fds, Gs^Fms, Gg^Ve, Gs^Fms, Gs^Fds, Gg, Gs^Fms, Gg, Gg, Gs^Fms, Gs^Fds, Gs^Fms, Gs^Fds, Gs^Fms, Gs^Fms, Gs^Fms, Gs^Fds, Gs^Fms, Gs^Fms, Gs^Fms, Gg, Gg, Gs^Fms, Gs^Fms, Gs^Fms, Gs^Fms, Gs^Fds
Ms^Xm, Gll^Fp, Gll^Fp, Gg^Ve, Gg, Gs^Fms, Gs^Fms, Gs^Fms, Gs^Fds, Gs^Fms, Gg, Gs^Fms, Gs^Fms, Gs^Fms, Gs^Fms, Gs^Fds, Gg, Gs^Fms, Gg, Gs^Fds, Gs^Fds, Gs^Fds, Gs^Fms, Gs^Fms, Gg, Gg, Gs^Fms, Gs^Fms, Gs^Fms, Gs^Fms, Gs^Fms, Gs^Fds, Gg, Gs^Fds, Gg, Gg, Gs^Fms, Gs^Fds, Gs^Fms, Gs^Fms, Gs^Fms, Gs^Fds, Gs^Fms, Gs^Fds, Gs^Fms, Gs^Fms, Gs^Fms, Gs^Fms, Gs^Fms, Gg, Gg, Gs^Fms, Gll^Fp, Gs^Fms
Ms^Xm, Gll^Fp, Gll^Fp, Gll^Fp, Gll^Fp, Gg, Gs^Fms, Gs^Fms, Gg, Gg, Gs^Fms, Gs^Fms, Gs^Fms, Gs^Fms, Gs^Fms, Gg, Gs^Fms, Gg, Cvr, Gg, Gg, Gs^Fms, Rr^Vd, Gg, Gg, Gg, Gg, Gs^Fms, Gs^Fms, Gs^Fms, Gs^Fms, Gs^Fms, Cvr, Gg, Gs^Fms, Gs^Fms, Gs^Fms, Gs^Fms, Gg, Gs^Fms, Gg, Gs^Fms, Gs^Fms, Gs^Fms, Gs^Fms, Gs^Fms, Gs^Fms, Gs^Fms, Gg, Gg, Gg, Gll^Fp, Gll^Fp, Gll^Fp
Ms^Xm, Gll^Fp, Gll^Fp, Gll^Fp, Gs^Fms, Gg, Gg, Gs^Fms, Gg, Gg^Es, Gs^Fms, Gs^Fms, Gs^Fms, Gs^Fms, Gs^Fms, Gg, Gs^Fms, Cvr, 1 Kvr, Cvr, Gs^Fms, Gg, Gg, Gg, Gs^Fms, Gs^Fms, Gs^Fms, Gg, Rr^Vd, Gs^Fms, Gs^Fms, Cvr, 2 Kvr, Cvr, Gs^Fms, Gs^Fms, Gs^Fms, Gg, Gs^Fms, Gg, Gs^Fms, Gg, Gg, Gg, Gg, Gg^Fet, Gg, Gg, Gll^Fp, Gll^Fp, Gll^Fp, Gg^Ve, Gll^Fp, Gll^Fp
Ms^Xm, Ms^Xm, Gll^Fp, Gll^Fp, Gs^Fms, Gs^Fms, Gs^Fms, Gg, Gg^Ve, Gg, Gg, Gs^Fms, Gg, Gs^Fms, Gs^Fms, Gg, Gs^Fms, Cvr, Cvr, Cvr, Gg, Gg, Gg, Gs^Fms, Gs^Fms, Gs^Fms, Gs^Fms, Gs^Fms, Gs^Fms, Gs^Fms, Gg, Cvr, Cvr, Cvr, Gs^Fms, Gg^Ve, Gg, Gg, Gll^Fp, Gll^Fp, Gll^Fp, Gll^Fp, Gll^Fp, Gll^Fp, Gll^Fp, Gg, Gs^Fms, Gs^Fms, Gll^Fp, Gll^Fp, Gll^Fp, Gll^Fp, Gll^Fp, Gll^Fp
Ms^Xm, Ms^Xm, Ms^Xm, Gll^Fp, Gs^Fms, Gs^Fms, Gs^Fms, Gs^Fms, Gs^Fms, Gs^Fms, Gs^Fms, Gg, Gs^Fms, Gg, Gg, Gg, Gs^Fms, Gs^Fms, Gs^Fms, Gg, Gg, Gg, Gg, Gg, Gg, Gs^Fms, Gg, Gs^Fms, Gg, Gg, Gg, Gg, Gs^Fms, Gg, Gs^Fms, Gs^Fms, Gg, Gll^Fp, Gll^Fp, Gll^Fp, Gll^Fp, Gll^Fp, Gll^Fp, Gll^Fp, Gll^Fp, Gs^Fms, Gs^Fms, Gs^Fms, Gll^Fp, Gll^Fp, Ms^Xm, Ms^Xm, Ms^Xm, Ms^Xm
Ms^Xm, Ms^Xm, Ms^Xm, Gs^Fms, Gll^Fp, Gll^Fp, Gll^Fp, Gll^Fp, Gs^Fms, Gs^Fms, Gs^Fms, Gs^Fms, Gs^Fms, Gs^Fms, Gs^Fms, Rr^Vd, Gs^Fms, Gs^Fms, Gs^Fms, Gg^Ve, Gs^Fms, Gs^Fms, Gs^Fms, Gg, Gg, Gg, Gg, Gg, Gg, Gg, Gs^Fms, Gs^Fms, Gs^Fms, Gg, Rr^Vd, Gg, Gll^Fp, Gll^Fp, Gll^Fp, Gll^Fp, Gll^Fp, Gll^Fp, Gll^Fp, Gll^Fp, Gll^Fp, Gs^Fms, Gll^Fp, Gll^Fp, Ms^Xm, Ms^Xm, Ms^Xm, Ms^Xm, Ms^Xm, Ms^Xm
Ms^Xm, Ms^Xm, Ms^Xm, Ms^Xm, Ms^Xm, Gll^Fp, Gll^Fp, Gll^Fp, Gll^Fp, Gll^Fp, Gll^Fp, Gs^Fms, Gs^Fms, Gs^Fms, Gs^Fms, Gs^Fms, Gs^Fms, Gs^Fms, Gs^Fms, Gs^Fms, Gs^Fms, Gs^Fms, Gs^Fms, Gs^Fms, Gg, Gg, Gg, Gg, Gs^Fms, Gs^Fms, Gs^Fms, Gs^Fms, Gll^Fp, Gs^Fms, Gll^Fp, Gll^Fp, Gll^Fp, Gll^Fp, Gll^Fp, Gll^Fp, Ms^Xm, Ms^Xm, Ms^Xm, Ms^Xm, Ms^Xm, Gs^Fms, Ms^Xm, Ms^Xm, Ms^Xm, Ms^Xm, Ms^Xm, Ms^Xm, Ms^Xm, Ms^Xm
Ms^Xm, Ms^Xm, Ms^Xm, Ms^Xm, Ms^Xm, Gll^Fp, Gll^Fp, Gll^Fp, Gll^Fp, Gll^Fp, Gll^Fp, Gs^Fms, Gs^Fms, Gs^Fms, Gs^Fms, Gs^Fms, Gs^Fms, Gs^Fms, Gs^Fms, Gs^Fms, Gs^Fms, Gs^Fms, Gs^Fms, Gs^Fms, Gg, Gg, Gg, Gs^Fms, Gs^Fms, Gs^Fms, Gs^Fms, Gll^Fp, Gll^Fp, Gll^Fp, Gll^Fp, Gll^Fp, Gll^Fp, Gll^Fp, Gg, Ms^Xm, Ms^Xm, Ms^Xm, Ms^Xm, Ms^Xm, Ms^Xm, Ms^Xm, Ms^Xm, Ms^Xm, Ms^Xm, Ms^Xm, Ms^Xm, Ms^Xm, Ms^Xm, Ms^Xm
