Wo, Wo, Wo, Wo, Wo, Wo, Wo, Wo, Wo, Wo, Wo, Wo, Wo, Wo, Wo, Wo, Wo, Wo, Wo, Wo, Wo, Wo, Wo, Wo, Wo, Wo, Wo, Wo, Wo, Wo, Wo, Wo, Wo, Wo, Wo, Wo, Wo, Wo, Wo, Wo, Wo, Wo, Wo, Gg, Gg, Gg, Gg, Gg, Gg, Gg, Gg, Gg, Gg, Gg, Gg, Gg, Gg, Gg, Gg, Ce, Gg, Gg^Dr
Wo, Wo, Wo, Wo, Wo, Wo, Wo, Wo, Wo, Wo, Wo, Wo, Wo, Wo, Wo, Wo, Wo, Wo, Wo, Wo, Wo, Wo, Wo, Wo, Wo, Wo, Wo, Wo, Wo, Wo, Wo, Wo, Wo, Wo, Wo, Wo, Wo, Wo, Gg, Wo, Gg, Wo, Gg, Gg, Gg, Gg, Gg, Gg, Gg, Gg, Gg, Gg, Gg, Gg, Gg, Gg, Gg^Dr, Gg, Ce, Ce, Ce, Gg^Dr
Wo, Wo, Wo, Wo, Wo, Wo, Wo, Wo, Wo, Wo, Wo, Wo, Wo, Wo, Wo, Wo, Wo, Wo, Wo, Wo, Wo, Wo, Wo, Wo, Wo, Wo, Gs^Fms, Wo, Gs^Fms, Wo, Gs^Fms, Gs^Fms, Gs^Fms, Wo, Gs^Fms, Gs^Fms, Gs^Fms, Gs^Fms, Gs^Fms, Gg, Gg, Gg, Gg, Gg, Gg, Gg, Gg, Gg, Gg, Gd^Fetd, Gg, Gg, Gg, Gg, Gg, Gg, Gg, Ce, Ce, Ce, Ce, Ce
Wo, Wo, Wo, Wo, Wo, Wo, Wo, Wo, Wo, Wo, Wo, Wo, Wo, Wo, Wo, Wo, Wo, Wo, Wo, Wo, Gg, Wo, Gg, Wo, Gs^Fms, Gs^Fms, Gs^Fms, Gs^Fms, Gs^Fms, Gs^Fms, Gs^Fms, Gs^Fms, Gs^Fms, Gs^Fms, Gs^Fms, Gs^Fms, Gs^Fms, Gs^Fms, Gs^Fms, Gg, Gg, Gg, Gg, Gg, Gg, Gg^Es, Gg, Gg, Gg, Gg, Gg^Edb, Gs^Vc, Gg^Gvs, Gg, Gg, Gg^Dr, Gg^Dr, Ce, Ce, Ke, Ce, Ce
Wo, Wo, Wo, Wo, Wo, Wo, Wo, Wo, Wo, Wo, Ww, Wo, Ww, Wo, Gg, Gg, Gg, Gg, Gg, Gg, Gg, Gg, Gg, Gg, Gs^Fms, Gs^Fms, Gs^Fms, Gs^Fms, Gs^Fms, Gs^Fms, Gs^Fms, Gs^Fms, Gs^Fms, Gs^Fms, Gs^Fms, Gs^Fms, Gs^Fms, Gs^Fms, Gg, Gg, Gg, Gg, Gg, Gg, Gg^Edb, Gg, Gg, Gg, Gg, Gg, Gg^Gvs, Gg^Gvs, Gg^Gvs, Gg^Es, Gg, Gd^Fetd, Gg, Ce, Ce, Ce, Ce, Ce
Wo, Wo, Wo, Wo, Wo, Wo, Wo, Wo, Ww, Ww, Ww, Ww, Gg, Gg, Gg, Gg, Gg, Gs^Vc, Gg, Gg, Gg, Gg, Gg, Gg, Gg, Gs^Fms, Gs^Fms, Gs^Fms, Gg, Gs^Fms, Gs^Fms, Gs^Fms, Gs^Fms, Gs^Fms, Gs^Fms, Gs^Fms, Gs^Fms, Gs^Fms, Gg, Gg^Es, Gg, Gg, Gg, Gs^Vc, Gg^Gvs, Gg^Gvs, Gg, Gg, Gg, Gg, Gg^Gvs, Gg^Gvs, Gg, Gg, Gg, Gg, Gg, Gg^Es, Gg, Ce, Gg, Gg
Wo, Wo, Wo, Wo, Wo, Wo, Gg, Ww, Gg, Ww, Ww, Ww, Gg, Gg, Gg, Gg, Gg^Efm, Gg, Gg, Gg, Gg, Gg, Gg, Gg, Gg, Gg, Gg, Gg, Gg, Gs^Fms, Gs^Fms, Gs^Fms, Gs^Fms, Gs^Fms, Gs^Fms, Gs^Fms, Gs^Fms, Gs^Fms, Gg, Gg, Gg, Gg, Gg, Gg^Gvs, Gg^Gvs, Gg^Gvs, Gg, Gg, Gg, Gg, Gg, Gg, Gg, Gg, Gs^Vc, Gg, Gg, Gg, Gg, Gg, Rb, Rb
Wo, Wo, Wo, Wo, Gg, Gg, Gg, Gg, Gg, Gg, Ww, Ww, Gg, Gg, Gg, Gg^Efm, Gg^Efm, Gg, Gg^Es, Gg, Rb^Gvs, Rb^Gvs, Rb^Gvs, Gs^Vc, Gg, Gg, Gg, Gg, Ce, Gg, Gg, Gs^Fms, Gs^Vc, Gs^Fms, Gs^Fms, Gs^Fms, Gs^Fms, Gs^Fms, Gs^Fms, Gg, Gg, Gg, Gg, Gg^Gvs, Gg, Gg, Gg, Gg, Rb, Rb, Rb, Rb, Rb, Rb, Rb, Gg^Gvs, Rb, Gg, Rb, Rb, Gg, Ss
Gg, Wo, Gg, Gg, Gg, Gg, Gg^Eff, Gg^Eff, Gg^Eff, Gg, Gg, Ww, Ww^Bw/, Gg, Gg, Gg^Efm, Gg^Efm, Gg^Efm, Gg, Rb^Gvs, Rb^Gvs, Rb^Gvs, Gg, Gg, Gg, Gg, Gg, Cer, Ke, Ce, Gg, Gg, Gs^Fms, Gs^Fms, Gs^Fms, Gs^Fms, Gs^Fms, Gs^Fms, Gs^Fms, Gs^Fms, Gs^Fms, Gg, Gg, Gg, Gg, Gg, Gg, Rb, Rb, Gg^Efs, Ss, Gg, Gg, Gg, Gg, Rb, Rb, Rb, Rb, Rb, Gg^Emf, Ss
Gg, Gg, Gg, Gg, Gg^Eff, Gg^Eff, Rb^Gvs, Gs^Vl, Gg^Vwm, Gg^Eff, Gg^Eff, Ww^Bw/, Ww, Gg, Gg, Gg, Gg^Efm, Gg^Efm, Gg, Gg, Re^Vct, Gg, Gg, Gg, Gg, Gg, Gg, Ce, Ce, Ce, Gg, Gg, Gg, Gg, Gs^Fms, Gs^Fms, Gs^Fms, Gs^Fms, Gs^Fms, Gs^Fms, Gs^Fms, Gg, Gg, Gg, Gg, Gg, Rb, Rb, Gg, Ss, Ss, Ss, Ss, Gg, Gg, Gg, Gg, Gg, Gg, Rb, Rb, Ss
Gg^Eff, Gg, Gg^Eff, Gg^Eff, Rb^Gvs, Rb^Gvs, Rb^Gvs, Rb^Gvs, Gg^Eff, Gg^Eff, Gg, Gg, Ww, Ww, Gg, Gg, Gg, Gg, Gg, Gs^Vc, Gg, Gg, Gg, Gg, Rb^Gvs, Gg, Gg, Gg, Gg, Gg, Gg, Gg, Gg, Gg, Gs^Fms, Gs^Fms, Gs^Fms, Gs^Fms, Gs^Fms, Gs^Fms, Gg, Gg, Gg, Gg^Es, Gg^Es, Gg, Rb, Gg, Ss, Ss, Ss, Ss, Ss, Ss, Ss, Gg, Gg, Gg, Gg^Gvs, Gg^Gvs, Ss, Rb
Rb^Gvs, Gg^Eff, Rb^Gvs, Rb^Gvs, Rb^Gvs, Rb^Gvs, Rb^Gvs, Rb^Gvs, Gg^Eff, Gg^Eff, Gg, Gg, Wwr, Wwr, Wwr, Gg, Ww, Gg, Ww, Gg, Gg, Gg, Rb^Gvs, Rb^Gvs, Rb^Gvs, Rb^Gvs, Gs^Vc, Gg, Gg, Gg, Gg, Gg^Es, Gg, Gg, Gg, Gs^Fms, Gs^Fms, Gs^Fms, Gs^Fms, Gs^Fms, Gg, Gg, Gg, Gg, Gg, Gg, Rb, Gg, Gg, Ss, Ss, Ss, Ss, Ss, Ss, Gg, Ss, Gg, Gg, Gg^Gvs, Ss, Ww^Ewl
Rb^Gvs, Rb^Gvs, Rb^Gvs, Rb^Gvs, Gg^Eff, Rb^Gvs, Gs^Vl, Gg^Eff, Gg^Eff, Gg, Gg^Efm, Gg, Gg, Wwr, Wwr, Wwr, Gg, Ww, Gg, Ww, Ww, Ww, Ww, Rb^Gvs, Ww, Gg, Gg, Gg, Gg, Gg, Gg, Gg, Gg, Gg, Gg, Gs^Fms, Gs^Fms, Gs^Fms, Gs^Fms, Gs^Fms, Gg, Gg, Gg, Gg, Gg^Edb, Gg, Rb, Rb, Gg, Ss, Gg, Ss, Ss, Ss, Ss, Ss, Ss, Ss, Ss, Ss, Ss, Ss
Gg^Eff, Rb^Gvs, Gg^Eff, Gg^Eff, Gg^Ecf, Gg^Eff, Gg^Eff, Gg^Eff, Gg, Gg^Es, Gg^Efm, Gg^Efm, Gg, Wwr, Ww, Gg, Gg, Gg, Gg, Gg, Gg, Ww, Gg, Ww, Gg, Ww, Gg, Gg, Gg, Gg, Gg, Gg, Gg, Gs^Vc, Gg, Gg, Gs^Fms, Gs^Fms, Gs^Fms, Gs^Fms, Gg, Gg, Gg, Gg, Gg, Gs^Vc, Gg^Gvs, Rb, Gg, Gg, Gg, Gg, Gg, Gg, Gg, Ss, Ss, Ss, Ss, Ss, Ss, Ss
Gg, Gg^Eff, Gg, Re^Vct, Gg, Gg, Gg^Ecf, Gg, Gg, Gg, Gg^Efm, Gg^Efm, Gg, Ww, Ww, Gg, Gg, Gg, Gg, Gg, Gg, Gg, Gg, Gg, Gg, Gg, Gg, Gg, Gg, Gg, Gg, Gg, Gg, Gg, Gg, Gs^Fms, Gs^Fms, Gs^Fms, Gs^Fms, Gs^Fms, Gs^Fms, Gg, Gg, Gg, Gg, Gg^Gvs, Gg^Efs, Rb, Rb, Gg, Gg, Gg, Gg^Es, Gg, Gg, Ss, Ss, Ss, Ss^Vhs, Ss, Ss, Ss
Gg, Gg, Ce, Ce, Ce, Re^Vct, Gg, Gg, Gg, Gg, Gg, Gg^Efm, Gg, Ww, Ww, Ww, Ww^Bw/, Gg^Es, Gg, Gg^Efm, Gg^Efm, Gg, Gg, Gg, Gg, Gg, Gg, Gg, Gg^Efm, Gg^Es, Gg, Gg, Gg, Gg, Gg, Gs^Fms, Gs^Fms, Gs^Fms, Gs^Fms, Gs^Fms, Gs^Fms, Gs^Fms, Gs^Fms, Gg, Gg, Gg, Gg, Gg, Gg, Rb, Rb, Gg, Gg^Efs, Gg, Gg, Ss, Ss, Ss, Ss, Ss, Ss, Ss
Gg, Gg, Ce, 1 Ke, Ce, Gg, Gg^Ecf, Gg, Gg^Eff, Gg^Eff, Gg^Eff, Gg, Gg, Gg, Gg, Ww^Bw/, Ww, Ww, Gg, Gg^Efm, Gg^Efm, Gg, Rb^Gvs, Rb^Gvs, Rb^Gvs, Gg, Gg, Gg, Gg^Efm, Gg^Efm, Gg^Efm, Gg, Gg, Gg, Gg, Gg, Gg, Gg, Gs^Fms, Gs^Fms, Gs^Fms, Gs^Fms, Gs^Fms, Gg, Gg, Gg, Gg, Gg, Gg, Gg, Gg, Rb, Rb, Gg, Ss, Ss, Ss, Ss, Ss, Ss, Ww^Ewl, Ss
Gg, Gg, Gg, Ce, Gg, Re^Vct, Gg^Eff, Gg^Eff, Rb^Gvs, Gs^Vl, Gg^Vwm, Gg^Eff, Gg^Eff, Gg, Gg^Es, Gg, Ww, Ww, Gg, Gg^Efm, Gg^Efm, Rb^Gvs, Rb^Gvs, Rb^Gvs, Gg, Gs^Vc, Gg, Gg, Gg^Efm, Gg^Efm, Gg^Efm, Gg^Efm, Gg, Gg, Gg, Gg, Gg, Gg, Gs^Fms, Gs^Fms, Gs^Fms, Gs^Fms, Gg, Gg, Gg^Gvs, Gg, Gg, Gg, Gg, Gg, Gg, Gg, Gg, Rb, Rb, Ss, Ss, Ss, Ss, Ss, Ss, Ss
Gg, Gg, Gg, Gg, Gg^Eff, Gg^Eff, Rb^Gvs, Rb^Gvs, Rb^Gvs, Rb^Gvs, Gg, Gg, Gg^Eff, Gg^Eff, Gg, Gg, Ww, Ww, Gg, Gg^Efm, Gg^Efm, Gg, Gg, Gg, Gg, Gg, Gg, Gg, Gg, Gg^Efm, Gg, Gg, Gg, Gg, Gg, Gg, Gg, Gs^Fms, Gs^Fms, Gs^Fms, Gg, Gg, Gg, Gg^Gvs, Gs^Vc, Gg, Gg, Gg^Es, Gg, Gg, Ss, Gg, Ss, Ss, Ss, Rb, Rb, Ss, Ss, Ss, Ss, Ss
Gg, Gg, Gg^Eff, Gg^Eff, Rb^Gvs, Rb^Gvs, Rb^Gvs, Rb^Gvs, Ww, Rb^Gvs, Gg^Eff, Gg^Eff, Ww, Gg, Gg, Gg, Ww, Ww, Ww, Gg, Gg^Efm, Gg, Gg, Gg, Gg, Gg, Gg, Gg, Gg, Gg, Gg, Gs^Vc, Gg, Gg, Gg, Gg, Gg, Gs^Fms, Gs^Fms, Gs^Fms, Gs^Fms, Gg, Gs^Fms, Gg, Gg, Gg^Edb, Gg, Gg, Ss, Ss, Ss, Ss, Ss, Ss, Ss, Ss, Ss^Efs, Rb, Rb, Rb, Rb, Ww^Ewl
Rb^Gvs, Gg, Rb^Gvs, Rb^Gvs, Rb^Gvs, Rb^Gvs, Ww, Ww, Ww, Ww, Ww, Ww, Ww, Ww, Ww, Ww, Ww, Ww, Ww, Gg, Gg, Gg, Gg, Gg, Gg, Gg, Gg, Gg, Rb^Gvs, Rb^Gvs, Rb^Gvs, Gg, Gg, Gg, Gg, Gg, Gg, Gs^Fms, Gs^Fms, Gs^Fms, Gs^Fms, Gs^Fms, Gs^Fms, Gs^Fms, Gg, Gg, Gg, Gg, Ss, Ss, Ss, Sm^Emf, Ss, Ss, Ss, Ss, Ss, Ww^Ewl, Ww^Ewl, Ss, Ss, Rb
Rb^Gvs, Rb^Gvs, Rb^Gvs, Rb^Gvs, Rb^Gvs, Ww, Gg^Eff, Gg^Eff, Gg, Ww, Gg, Ww, Gg, Ww, Ww, Ww, Ww, Ww, Wwr, Wwr, Gg, Gg, Gg, Gg, Gg^Es, Gg, Gs, Rb^Gvs, Rb^Gvs, Rb^Gvs, Gg, Gg, Gg, Gg, Gg, Gg, Gg, Gg, Gs^Vc, Gs^Fms, Gs^Fms, Gs^Fms, Gs^Fms, Gs^Fms, Gs^Fms, Gg, Gg, Ss, Ss, Ss, Sm, Sm, Ss, Ss, Ss, Ss, Ss, Ss, Ss, Ss, Ss^Vhs, Ss
Rb^Gvs, Rb^Gvs, Rb^Gvs, Rb^Gvs, Gs^Vl, Gg^Eff, Gg^Eff, Gg, Gg, Gg, Gg, Gg, Gs, Gg, Gg, Ww, Gs, Wwr, Wwr, Wwr, Gg, Gg, Gs, Gs, Gs, Gs, Gs, Gs, Gs, Gg, Gg, Gg, Gg, Gg, Gg, Gg, Gg, Gg, Gg, Gs^Fms, Gs^Fms, Gs^Fms, Gs^Fms, Gs^Fms, Gs^Fms, Gg, Ss, Ss, Ss, Ss, Sm, Sm, Sm, Ss, Ss, Ss, Ss, Ss, Ss, Ss, Ss, Ss
Gg^Eff, Rb^Gvs, Gg^Eff, Gg^Eff, Gg^Eff, Gg^Eff, Gg^Ecf, Gg, Gg, Gg, Gs, Gs, Gs, Gs, Gs, Gs, Gs, Gs, Gs, Ww, Ww, Gs, Gs, Gs, Gs, Gs, Gs, Gs, Gs, Gg, Gg, Gg^Es, Gg, Gg, Gg, Gg, Ce, Gg, Gg, Gg, Gs^Fms, Gs^Fms, Gs^Fms, Gs^Fms, Gs^Fms, Gg, Ss, Ss, Ss, Sm, Sm, Sm, Sm, Sm, Sm, Ss, Ww^Ewl, Ss, Rb, Ss, Rb, Ss
Gg, Gg^Eff, Ce, Ce, Ce, Re^Vct, Gg, Gg, Gs, Gs, Gs, Gs, Gs, Gs, Gs, Gs, Gs, Gs, Gs, Ww, Ww, Gs, Gs, Gs, Gs, Gs, Gs, Gs, Gs, Gs^Vc, Gs, Gg, Gs, Gg, Gs, Ce, Ke, Ce, Gg, Gs, Gs^Fms, Gs^Fms, Gs^Fms, Gs^Fms, Gs^Fms, Gg, Gg, Ss, Ss, Sm, Sm, Sm, Sm, Sm, Sm, Ss, Rb, Rb, Ss^Efs, Rb, Ss, Rb
Gg, Gg, Ce, 2 Ke, Ce, Gg, Gg^Ecf, Gg, Gs, Gs, Gs, Gs, Gs, Gs, Gs, Gs, Gs, Gs, Gs, Ww, Ww^Bw/, Gs, Gs, Gs, Gs, Gs, Gs, Gs, Gs, Gs, Gs, Gs, Gs, Gs, Gs, Ce, Ce, Ce, Gs, Gs, Gs^Fms, Gs^Fms, Gs^Fms, Gs^Fms, Gs^Fms, Gs^Fms, Gs^Fms, Ss, Ss, Sm, Sm, Sm, Sm, Sm, Gs^Vc, Rb, Ss, Ss, Ss, Ss, Ss, Ss
Gs^Fms, Gg, Gg, Ce, Gg, Re^Vct, Gs, Gs, Gs, Gs, Gs, Gs, Gs, Gs, Gs, Gs, Gs, Gs, Gs, Gs, Ww, Ww, Wwt, Gs, Gs, Gs, Hh, Hh, Hh, Hh, Hh, Gs, Hh, Gs, Gs, Gs, Gs, Gs, Gs, Gs^Fms, Gs^Fms, Gs^Fms, Gs^Fms, Gs^Fms, Gs^Fms, Gs^Fms, Ss, Ss, Ss, Ss, Sm, Sm, Sm, Sm, Sm, Ss, Ss, Ss, Ss, Ss, Ss, Ss
Gs^Fms, Gs^Fms, Gs^Fms, Re^Vct, Gg, Gg^Fet, Gs^Fms, Gs^Fms, Gs^Fms, Gs, Gs, Gs, Gs, Gs, Gs, Gs, Gs, Gs, Gs, Gs, Gs, Ww, Wwr, Wwr, Wwt, Hh, Hh, Hh, Hh, Hh, Hh, Hh, Hh, Hh, Hh, Gs, Gs, Gs, Gs, Gs, Gs^Fms, Gs^Fms, Gs^Fms, Gs^Fms, Gs^Fms, Gs^Fms, Gs^Fms, Ss, Ss, Ss, Sm, Sm, Sm, Sm, Sm, Sm, Sm, Ss, Ss, Ss, Ww^Ewl, Ss
Gs^Fms, Gs^Fms, Gs^Fms, Gg^Ecf, Gs^Fms, Gg, Gs^Fms, Gs^Fms, Gs^Fms, Gs, Gs, Gs, Gs, Gs, Gs, Gs, Gs, Gs, Gs, Gs, Hh, Gs, Hh, Wwt, Wwt, Wwt, Wwt, Ha, Ms, Ha, Ms, Ha, Ms, Ha, Ha, Hh, Aa^Fma, Gs, Gll^Fp, Gs^Fms, Gll^Fp, Gs^Fms, Gll^Fp, Gs^Fms, Gs^Fms, Gs^Fms, Gs^Fms, Gs^Fms, Gs^Fms, Hh, Hh, Sm, Sm, Sm, Sm, Sm, Sm, Sm, Sm^Emf, Ss, Ss, Ss
Gs^Fms, Gs^Fms, Gs^Fms, Gs^Fms, Gs^Fms, Gs^Fms, Gs^Fms, Gs^Fms, Gs^Fms, Gs^Fms, Gs^Fms, Gs, Gs, Gs, Gs, Gs, Gs, Gs, Hh, Hh, Hh, Hh, Ha, Ha, Ms, Wwt, Wwt, Wwt, Ai, Ms, Ms, Ms, Ms, Ms, Ms, Ha, Ha, Aa^Fma, Aa^Fma, Gll^Fp, Gll^Fp, Gll^Fp, Gll^Fp, Gll^Fp, Gll^Fp, Gll^Fp, Gll^Fp, Gs^Fms, Gs^Fms, Gs^Fms, Gs^Fms, Gs^Fms, Gs^Fms, Sm^Emf, Hh, Hh, Hh, Hh, Hh, Hh, Hh, Ss
Gs^Fms, Gs^Fms, Gs^Fms, Gs^Fms, Gg^Ve, Gs^Fms, Gs^Fms, Gs^Fms, Gs^Fms, Gg^Fet, Gs^Fms, Gs^Fms, Gs^Fms, Gs, Gs, Gs, Gs, Hh, Hh, Hh, Hh, Hh, Ha, Ms, Ms, Ms, Wwt, Wwt, Ai, Ai, Ms, Ms, Ms, Ms, Ha, Ha, Aa^Fda, Aa^Fda, Aa^Fda, Gll^Fp, Gll^Fp, Gll^Fp, Gll^Fp, Gll^Fp, Gll^Fp, Gll^Fp, Gll^Fp, Gll^Fp, Gll^Fp, Gs^Fms, Gs^Fms, Gs^Fms, Gs^Fms, Gs^Fms, Gs^Fms, Gg, Hh, Hh, Hh, Gg, Hh, Hh
Gs^Fms, Gs^Fms, Gs^Fms, Gs^Fms, Gs^Fms, Gs^Fms, Gs^Fms, Gs^Fms, Gs^Fms, Gs^Fms, Gg, Gs^Fms, Gs^Fms, Gs^Fms, Hh, Hh, Hh, Hh, Hh, Hh, Ha, Ha, Ha, Ms, Ms, Ms, Ms, Ai, Ai, Ai, Ai, Ms, Ms, Ms, Ms, Ha, Aa^Fda, Aa^Fda, Aa^Fda, Aa^Fda, Aa^Fda, Aa^Fda, Aa^Fda, Gll^Fp, Gll^Fp, Gll^Fp, Gll^Fp, Gll^Fp, Gll^Fp, Gll^Fp, Gll^Fp, Gs^Fms, Gs^Fms, Gs^Fms, Gs^Fms, Gs^Fms, Gs^Fms, Hh, Hh, Hh, Gg, Hh
