Wo, Wo, Wo, Wo, Wo, Wo, Wo, Wo, Wo, Wo, Wo, Wo, Wo, Wo, Wo, Wo, Wo, Wo, Wo, Wo, Wo, Wo, Wo, Wo, Wo, Wo, Wo, Wo, Wo, Wo, Wo, Wo, Wo, Wo, Wo, Wo, Wo, Wo, Wo, Wo, Wo, Wo, Wo, Gg, Gg, Gg, Gg, Gg, Gg, Gg, Gg, Gg, Gg, Gg, Gg, Gg, Gg, Gg, Gg, Ce, Gg, Gg^Dr
Wo, Wo, Wo, Wo, Wo, Wo, Wo, Wo, Wo, Wo, Wo, Wo, Wo, Wo, Wo, Wo, Wo, Wo, Wo, Wo, Wo, Wo, Wo, Wo, Wo, Wo, Wo, Wo, Wo, Wo, Wo, Wo, Wo, Wo, Wo, Wo, Wo, Wo, Gg, Wo, Gg, Wo, Gg, Gg, Gg, Gg, Gg, Gg, Gg, Gg, Gg, Gg, Gg, Gg, Gg, Gg, Gg^Dr, Gg, Ce, Ce, Ce, Gg^Dr
Wo, Wo, Wo, Wo, Wo, Wo, Wo, Wo, Wo, Wo, Wo, Wo, Wo, Wo, Wo, Wo, Wo, Wo, Wo, Wo, Wo, Wo, Wo, Wo, Wo, Wo, Gs^Fms, Wo, Gs^Fms, Wo, Gs^Fms, Gs^Fms, Gs^Fms, Wo, Gs^Fms, Gs^Fms, Gs^Fms, Gs^Fms, Gs^Fms, Gg, Gg, Gg, Gg, Gg, Gg, Gg, Gg, Gg, Gg, Gd^Fetd, Gg, Gg, Gg, Gg, Gg, Gg, Gg, Ce, Ce, Ce, Ce, Ce
Wo, Wo, Wo, Wo, Wo, Wo, Wo, Wo, Wo, Wo, Wo, Wo, Wo, Wo, Wo, Wo, Wo, Wo, Wo, Wo, Gg, Wo, Gg, Wo, Gs^Fms, Gs^Fms, Gs^Fms, Gs^Fms, Gs^Fms, Gs^Fms, Gs^Fms, Gs^Fms, Gs^Fms, Gs^Fms, Gs^Fms, Gs^Fms, Gs^Fms, Gs^Fms, Gs^Fms, Gg, Gg, Gg, Gg, Gg, Gg, Gg^Es, Gg, Gg, Gg, Gg, Gg^Edb, Gs^Vc, Gg^Gvs, Gg, Gg, Gg^Dr, Gg^Dr, Ce, Ce, Ke, Ce, Ce
Wo, Wo, Wo, Wo, Wo, Wo, Wo, Wo, Wo, Wo, Ww, Wo, Ww, Wo, Gg, Gg, Gg, Gg, Gg, Gg, Gg, Gg, Gg, Gg, Gs^Fms, Gs^Fms, Gs^Fms, Gs^Fms, Gs^Fms, Gs^Fms, Gs^Fms, Gs^Fms, Gs^Fms, Gs^Fms, Gs^Fms, Gs^Fms, Gs^Fms, Gs^Fms, Gg, Gg, Gg, Gg, Gg, Gg, Gg^Edb, Gg, Gg, Gg, Gg, Gg, Gg^Gvs, Gg^Gvs, Gg^Gvs, Gg^Es, Gg, Gd^Fetd, Gg, Ce, Ce, Ce, Ce, Ce
Wo, Wo, Wo, Wo, Wo, Wo, Wo, Wo, Ww, Ww, Ww, Ww, Gg, Gg, Gg, Gg, Gg, Gs^Vc, Gg, Gg, Gg, Gg, Gg, Gg, Gg, Gs^Fms, Gs^Fms, Gs^Fms, Gg, Gs^Fms, Gs^Fms, Gs^Fms, Gs^Fms, Gs^Fms, Gs^Fms, Gs^Fms, Gs^Fms, Gs^Fms, Gg, Gg^Es, Gg, Gg, Gg, Gs^Vc, Gg^Gvs, Gg^Gvs, Gg, Gg, Gg, Gg, Gg^Gvs, Gg^Gvs, Gg, Gg, Gg, Gg, Gg, Gg^Es, Gg, Ce, Gg, Gg
Wo, Wo, Wo, Wo, Wo, Wo, Gg, Ww, Gg, Ww, Ww, Ww, Gg, Gg, Gg, Gg, Gg^Efm, Gg, Gg, Gg, Gg, Gg, Gg, Gg, Gg, Gg, Gg, Gg, Gg, Gs^Fms, Gs^Fms, Gs^Fms, Gs^Fms, Gs^Fms, Gs^Fms, Gs^Fms, Gs^Fms, Gs^Fms, Gg, Gg, Gg, Gg, Gg, Gg^Gvs, Gg^Gvs, Gg^Gvs, Gg, Gg, Gg, Gg, Gg, Gg, Gg, Gg, Gs^Vc, Gg, Gg, Gg, Gg, Gg, Sm, Sm^Dr
Wo, Wo, Wo, Wo, Gg, Gg, Gg, Gg, Gg, Gg, Ww, Ww, Gg, Gg, Gg, Gg^Efm, Gg^Efm, Gg, Gg^Es, Gg, Rb^Gvs, Rb^Gvs, Rb^Gvs, Gs^Vc, Gg, Gg, Gg, Gg, Ce, Gg, Gg, Gs^Fms, Gs^Vc, Gs^Fms, Gs^Fms, Gs^Fms, Gs^Fms, Gs^Fms, Gs^Fms, Gg, Gg, Gg, Gg, Gg^Gvs, Gg, Gg, Gg, Gg, Sm, Sm, Sm, Sm, Sm, Sm, Sm, Gg^Gvs, Sm, Gg, Sm, Sm, Gg, Ss
Gg, Wo, Gg, Gg, Gg, Gg, Gg^Eff, Gg^Eff, Gg^Eff, Gg, Gg, Ww, Ww^Bw/, Gg, Gg, Gg^Efm, Gg^Efm, Gg^Efm, Gg, Rb^Gvs, Rb^Gvs, Rb^Gvs, Gg, Gg, Gg, Gg, Gg, Cer, Ke, Ce, Gg, Gg, Gs^Fms, Gs^Fms, Gs^Fms, Gs^Fms, Gs^Fms, Gs^Fms, Gs^Fms, Gs^Fms, Gs^Fms, Gg, Gg, Gg, Gg, Gg, Gg, Sm, Sm, Gg^Efs, Ss, Gg, Gg, Gg, Gg, Sm^Efs, Sm, Sm, Sm, Sm, Gg^Emf, Ss
Gg, Gg, Gg, Gg, Gg^Eff, Gg^Eff, Rb^Gvs, Gs^Vl, Gg^Vwm, Gg^Eff, Gg^Eff, Ww^Bw/, Ww, Gg, Gg, Gg, Gg^Efm, Gg^Efm, Gg, Gg, Re^Vct, Gg, Gg, Gg, Gg, Gg, Gg, Ce, Ce, Ce, Gg, Gg, Gg, Gg, Gs^Fms, Gs^Fms, Gs^Fms, Gs^Fms, Gs^Fms, Gs^Fms, Gs^Fms, Gg, Gg, Gg, Gg, Gg, Sm, Sm, Gg, Ss, Ss, Ss, Ss, Gg, Gg, Gg, Gg, Gg, Gg, Sm, Sm, Ss
Gg^Eff, Gg, Gg^Eff, Gg^Eff, Rb^Gvs, Rb^Gvs, Rb^Gvs, Rb^Gvs, Gg^Eff, Gg^Eff, Gg, Gg, Ww, Ww, Gg, Gg, Gg, Gg, Gg, Gs^Vc, Gg, Gg, Gg, Gg, Rb^Gvs, Gg, Gg, Gg, Gg, Gg, Gg, Gg, Gg, Gg, Gs^Fms, Gs^Fms, Gs^Fms, Gs^Fms, Gs^Fms, Gs^Fms, Gg, Gg, Gg, Gg^Es, Gg^Es, Gg, Sm, Gg, Ss, Ss, Ss, Ss, Ss, Ss, Ss, Gg, Gg, Gg, Gg^Gvs, Gg^Gvs, Ss, Sm^Efs
Rb^Gvs, Gg^Eff, Rb^Gvs, Rb^Gvs, Rb^Gvs, Rb^Gvs, Rb^Gvs, Rb^Gvs, Gg^Eff, Gg^Eff, Gg, Gg, Wwr, Wwr, Wwr, Gg, Ww, Gg, Ww, Gg, Gg, Gg, Rb^Gvs, Rb^Gvs, Rb^Gvs, Rb^Gvs, Gs^Vc, Gg, Gg, Gg, Gg, Gg^Es, Gg, Gg, Gg, Gs^Fms, Gs^Fms, Gs^Fms, Gs^Fms, Gs^Fms, Gg, Gg, Gg, Gg, Gg, Gg, Sm, Gg, Gg, Ss, Ss, Ss, Ss, Ss, Ss, Gg, Ss, Gg, Gg, Gg^Gvs, Ss, Ww^Ewl
Rb^Gvs, Rb^Gvs, Rb^Gvs, Rb^Gvs, Gg^Eff, Rb^Gvs, Gs^Vl, Gg^Eff, Gg^Eff, Gg, Gg^Efm, Gg, Gg, Wwr, Wwr, Wwr, Gg, Ww, Gg, Ww, Ww, Ww, Ww, Rb^Gvs, Ww, Gg, Gg, Gg, Gg, Gg, Gg, Gg, Gg, Gg, Gg, Gs^Fms, Gs^Fms, Gs^Fms, Gs^Fms, Gs^Fms, Gg, Gg, Gg, Gg, Gg^Edb, Gg, Sm, Sm, Gg, Ss, Gg, Ss, Ss, Ss, Ss, Ss, Ss, Ss, Ss, Ss, Ss, Ss
Gg^Eff, Rb^Gvs, Gg^Eff, Gg^Eff, Gg^Ecf, Gg^Eff, Gg^Eff, Gg^Eff, Gg, Gg^Es, Gg^Efm, Gg^Efm, Gg, Wwr, Ww, Gg, Gg, Gg, Gg, Gg, Gg, Ww, Gg, Ww, Gg, Ww, Gg, Gg, Gg, Gg, Gg, Gg, Gg, Gs^Vc, Gg, Gg, Gs^Fms, Gs^Fms, Gs^Fms, Gs^Fms, Gg, Gg, Gg, Gg, Gg, Gs^Vc, Gg^Gvs, Sm, Gg, Gg, Gg, Gg, Gg, Gg, Gg, Ss, Ss, Ss, Ss, Ss, Ss, Ss
Gg, Gg^Eff, Gg, Re^Vct, Gg, Gg, Gg^Ecf, Gg, Gg, Gg, Gg^Efm, Gg^Efm, Gg, Ww, Ww, Gg, Gg, Gg, Gg, Gg, Gg, Gg, Gg, Gg, Gg, Gg, Gg, Gg, Gg, Gg, Gg, Gg, Gg, Gg, Gg, Gs^Fms, Gs^Fms, Gs^Fms, Gs^Fms, Gs^Fms, Gs^Fms, Gg, Gg, Gg, Gg, Gg^Gvs, Gg^Efs, Sm, Sm, Gg, Gg, Gg, Gg^Es, Gg, Gg, Ss, Ss, Ss, Ss^Vhs, Ss, Ss, Ss
Gg, Gg, Ce, Ce, Ce, Re^Vct, Gg, Gg, Gg, Gg, Gg, Gg^Efm, Gg, Ww, Ww, Ww, Ww^Bw/, Gg^Es, Gg, Gg^Efm, Gg^Efm, Gg, Gg, Gg, Gg, Gg, Gg, Gg, Gg^Efm, Gg^Es, Gg, Gg, Gg, Gg, Gg, Gs^Fms, Gs^Fms, Gs^Fms, Gs^Fms, Gs^Fms, Gs^Fms, Gs^Fms, Gs^Fms, Gg, Gg, Gg, Gg, Gg, Gg, Sm, Sm, Gg, Gg^Efs, Gg, Gg, Ss, Ss, Ss, Ss, Ss, Ss, Ss
Gg, Gg, Ce, 1 Ke, Ce, Gg, Gg^Ecf, Gg, Gg^Eff, Gg^Eff, Gg^Eff, Gg, Gg, Gg, Gg, Ww^Bw/, Ww, Ww, Gg, Gg^Efm, Gg^Efm, Gg, Rb^Gvs, Rb^Gvs, Rb^Gvs, Gg, Gg, Gg, Gg^Efm, Gg^Efm, Gg^Efm, Gg, Gg, Gg, Gg, Gg, Gg, Gg, Gs^Fms, Gs^Fms, Gs^Fms, Gs^Fms, Gs^Fms, Gg, Gg, Gg, Gg, Gg, Gg, Gg, Gg, Sm, Sm, Gg, Ss, Ss, Ss, Ss, Ss, Ss, Ww^Ewl, Ss
Gg, Gg, Gg, Ce, Gg, Re^Vct, Gg^Eff, Gg^Eff, Rb^Gvs, Gs^Vl, Gg^Vwm, Gg^Eff, Gg^Eff, Gg, Gg^Es, Gg, Ww, Ww, Gg, Gg^Efm, Gg^Efm, Rb^Gvs, Rb^Gvs, Rb^Gvs, Gg, Gs^Vc, Gg, Gg, Gg^Efm, Gg^Efm, Gg^Efm, Gg^Efm, Gg, Gg, Gg, Gg, Gg, Gg, Gs^Fms, Gs^Fms, Gs^Fms, Gs^Fms, Gg, Gg, Gg^Gvs, Gg, Gg, Gg, Gg, Gg, Gg, Gg, Gg, Sm, Sm, Ss, Ss, Ss, Ss, Ss, Ss, Ss
Gg, Gg, Gg, Gg, Gg^Eff, Gg^Eff, Rb^Gvs, Rb^Gvs, Rb^Gvs, Rb^Gvs, Gg, Gg, Gg^Eff, Gg^Eff, Gg, Gg, Ww, Ww, Gg, Gg^Efm, Gg^Efm, Gg, Gg, Gg, Gg, Gg, Gg, Gg, Gg, Gg^Efm, Gg, Gg, Gg, Gg, Gg, Gg, Gg, Gs^Fms, Gs^Fms, Gs^Fms, Gg, Gg, Gg, Gg^Gvs, Gs^Vc, Gg, Gg, Gg^Es, Gg, Gg, Gg, Gg, Gg, Gg, Ss, Sm, Sm, Ss, Ss, Ss, Ss, Ss
Gg, Gg, Gg^Eff, Gg^Eff, Rb^Gvs, Rb^Gvs, Rb^Gvs, Rb^Gvs, Ww, Rb^Gvs, Gg^Eff, Gg^Eff, Ww, Gg, Gg, Gg, Ww, Ww, Ww, Gg, Gg^Efm, Gg, Gg, Gg, Gg, Gg, Gg, Gg, Gg, Gg, Gg, Gs^Vc, Gg, Gg, Gg, Gg, Gg, Gs^Fms, Gs^Fms, Gs^Fms, Gs^Fms, Gg, Gs^Fms, Gg, Gg, Gg^Edb, Gg, Gg, Gg, Gg, Gg, Gg, Gg, Ss, Ss, Ss, Ss^Efs, Sm, Sm, Sm, Sm, Ww^Ewl
Rb^Gvs, Gg, Rb^Gvs, Rb^Gvs, Rb^Gvs, Rb^Gvs, Ww, Ww, Ww, Ww, Ww, Ww, Ww, Ww, Ww, Ww, Ww, Ww, Ww, Gg, Gg, Gg, Gg, Gg, Gg, Gg, Gg, Gg, Rb^Gvs, Rb^Gvs, Rb^Gvs, Gg, Gg, Gg, Gg, Gg, Gg, Gs^Fms, Gs^Fms, Gs^Fms, Gs^Fms, Gs^Fms, Gs^Fms, Gs^Fms, Gg, Gg, Gg, Gg, Gg, Gg, Gg, Gg, Ss, Ss, Ss, Ss, Ss, Ww^Ewl, Ww^Ewl, Ss, Ss, Sm
Rb^Gvs, Rb^Gvs, Rb^Gvs, Rb^Gvs, Rb^Gvs, Ww, Gg^Eff, Gg^Eff, Gg, Ww, Gg, Ww, Gg, Ww, Ww, Ww, Ww, Ww, Wwr, Wwr, Gg, Gg, Gg, Gg, Gg^Es, Gg, Gg, Rb^Gvs, Rb^Gvs, Rb^Gvs, Gg, Gg, Gg, Gg, Gg, Gg, Gg, Gg, Gs^Vc, Gs^Fms, Gs^Fms, Gs^Fms, Gs^Fms, Gs^Fms, Gs^Fms, Gg, Gg, Gg, Gg, Gg, Gg, Gg, Ss, Ss, Ss, Ss, Ss, Ss, Ss, Ss, Ss^Vhs, Ss
Rb^Gvs, Rb^Gvs, Rb^Gvs, Rb^Gvs, Gs^Vl, Gg^Eff, Gg^Eff, Gg, Gg, Gg, Gg, Gg, Gg, Gg, Gg, Ww, Gg, Wwr, Wwr, Wwr, Gg, Gg, Gg^Efm, Gg, Gg^Efm, Gg, Gg, Gg, Gg, Gg, Gg, Gg, Gg, Gg, Gg, Gg, Gg, Gg, Gg, Gs^Fms, Gs^Fms, Gs^Fms, Gs^Fms, Gs^Fms, Gs^Fms, Gg, Gg, Gg, Gg, Gg, Gg, Gg, Gg, Ss, Ss, Ss, Ss, Ss, Ss, Ss, Ss, Ss
Gg^Eff, Rb^Gvs, Gg^Eff, Gg^Eff, Gg^Eff, Gg^Eff, Gg^Ecf, Gg, Gg, Gg, Gg, Gg, Gg, Gg, Gg, Gg, Gg, Gg, Gg, Ww, Ww, Gg, Gg, Gg^Efm, Gg^Efm, Gg^Efm, Gg, Gg, Gg, Gg, Gg, Gg^Es, Gg, Gg, Gg, Gg, Ce, Gg, Gg, Gg, Gs^Fms, Gs^Fms, Gs^Fms, Gs^Fms, Gs^Fms, Gg, Gg, Gg, Gg, Gg, Gg, Gg, Gg, Gg, Gg, Ss, Ww^Ewl, Ss, Sm, Ss, Sm, Ss
Gg, Gg^Eff, Ce, Ce, Ce, Re^Vct, Gg, Gg, Gg, Gg, Gg^Es, Gg, Gg, Gg, Gg, Gg^Es, Gg, Gg, Gg, Ww, Ww, Gg, Gg, Gg^Efm, Gg^Efm, Gg^Efm, Gg, Gg, Gg, Gs^Vc, Gg, Gg, Gg, Gg, Gg, Ce, Ke, Ce, Gg, Gg, Gs^Fms, Gs^Fms, Gs^Fms, Gs^Fms, Gs^Fms, Gg, Gg, Gg, Gg, Gg, Gg, Gg, Gg, Gg, Gg^Emf, Ss, Sm, Sm, Ss^Efs, Sm, Ss, Sm
Gg, Gg, Ce, 2 Ke, Ce, Gg, Gg^Ecf, Gg, Gg, Gg, Gg^Efm, Gg, Gg, Gg^Efm, Gg^Efm, Gg^Efm, Gg, Gg, Gg, Ww, Ww^Bw/, Gg, Gg, Gg^Efm, Gg^Efm, Gg^Efm, Gg, Gg, Gg, Gg, Gg, Gg, Gg, Gg, Gg, Ce, Ce, Ce, Gg, Gg, Gs^Fms, Gs^Fms, Gs^Fms, Gs^Fms, Gs^Fms, Gs^Fms, Gs^Fms, Gg, Gg, Gg, Gg, Gg, Gg, Gg^Emf, Gs^Vc, Sm, Ss, Ss, Ss, Ss, Ss, Ss
Gs^Fms, Gg, Gg, Ce, Gg, Re^Vct, Gg, Gg, Gg, Gg, Gg, Gg^Efm, Gg^Efm, Gg^Efm, Gg^Efm, Gg^Efm, Gg^Efm, Gg, Gg, Gg, Ww, Ww, Wwt, Gg, Gg, Gg^Efm, Hh, Hh, Hh, Hh, Hh, Gg, Hh, Gg, Gg, Gg, Gg, Gg, Gg, Gs^Fms, Gs^Fms, Gs^Fms, Gs^Fms, Gs^Fms, Gs^Fms, Gs^Fms, Gs^Fms, Gs^Fms, Gg, Gg, Gg, Gg, Gg, Gg^Edb, Gg^Emf, Ss, Ss, Ss, Ss, Ss, Ss, Ss
Gs^Fms, Gs^Fms, Gs^Fms, Re^Vct, Gg, Gg^Fet, Gs^Fms, Gs^Fms, Gs^Fms, Gg, Gg, Gg^Efm, Gg, Gg^Efm, Gg^Efm, Gg^Efm, Gg^Efm, Gg, Gg, Gg, Gg, Ww, Wwr, Wwr, Wwt, Hh, Hh, Hh, Hh, Hh, Hh, Hh, Hh, Hh, Hh, Gg, Gg, Gg, Gg, Gs^Fms, Gs^Fms, Gs^Fms, Gs^Fms, Gs^Fms, Gs^Fms, Gs^Fms, Gs^Fms, Gs^Fms, Gg, Gg, Gg, Gg, Gg, Gg, Gg, Gg, Gg, Ss, Ss, Ss, Ww^Ewl, Ss
Gs^Fms, Gs^Fms, Gs^Fms, Gg^Ecf, Gs^Fms, Gg, Gs^Fms, Gs^Fms, Gs^Fms, Gg, Gg, Gg, Gg, Gg, Gg, Gg^Efm, Gg, Gg, Gg, Gg^Es, Hh, Gg, Hh, Wwt, Wwt, Wwt, Wwt, Ha, Ms, Ha, Ha, Hh, Hh, Hh, Hh, Hh, Gll^Fp, Gg, Gll^Fp, Gs^Fms, Gll^Fp, Gs^Fms, Gll^Fp, Gs^Fms, Gs^Fms, Gs^Fms, Gs^Fms, Gs^Fms, Gs^Fms, Hh, Hh, Gg, Gg, Gg, Gg, Gg, Gg, Gg, Gg, Ss, Ss, Ss
Gs^Fms, Gs^Fms, Gs^Fms, Gs^Fms, Gs^Fms, Gs^Fms, Gs^Fms, Gs^Fms, Gs^Fms, Gs^Fms, Gs^Fms, Gs^Fms, Gs^Fms, Gg, Hh, Gg, Hh, Hh, Hh, Hh, Hh, Hh, Ha, Ha, Ha, Wwt, Wwt, Wwt, Wwt, Ms, Ms, Ha, Ms, Ha, Ha, Gll^Fp, Gll^Fp, Gll^Fp, Gll^Fp, Gll^Fp, Gll^Fp, Gll^Fp, Gll^Fp, Gll^Fp, Gll^Fp, Gll^Fp, Gll^Fp, Gs^Fms, Gs^Fms, Gs^Fms, Gs^Fms, Gs^Fms, Gs^Fms, Gg, Hh, Hh, Hh, Hh, Hh, Hh, Hh, Ss
Gs^Fms, Gs^Fms, Gs^Fms, Gs^Fms, Gg^Ve, Gs^Fms, Gs^Fms, Gs^Fms, Gs^Fms, Gg^Fet, Gs^Fms, Gs^Fms, Gs^Fms, Hh, Gg, Hh, Gg, Hh, Hh, Hh, Hh, Hh, Hh, Ms, Ha, Ms, Wwt, Wwt, Wwt, Wwt, Ms, Ms, Ha, Ms, Ha, Ha, Aa^Fda, Aa^Fda, Aa^Fda, Gll^Fp, Gll^Fp, Gll^Fp, Gll^Fp, Gll^Fp, Gll^Fp, Gll^Fp, Gll^Fp, Gll^Fp, Gll^Fp, Gs^Fms, Gs^Fms, Gs^Fms, Gs^Fms, Gs^Fms, Gs^Fms, Gg, Hh, Hh, Hh, Gg, Hh, Hh
Gs^Fms, Gs^Fms, Gs^Fms, Gs^Fms, Gs^Fms, Gs^Fms, Gs^Fms, Gs^Fms, Gs^Fms, Gs^Fms, Gg, Gs^Fms, Gs^Fms, Gs^Fms, Hh, Hh, Hh, Hh, Hh, Hh, Hh, Hh, Hh, Ha, Ms, Ha, Ms, Wwt, Wwt, Wwt, Wwt, Ms, Ms, Ms, Ms, Ha, Aa^Fda, Aa^Fda, Aa^Fda, Aa^Fda, Aa^Fda, Aa^Fda, Aa^Fda, Gll^Fp, Gll^Fp, Gll^Fp, Gll^Fp, Gll^Fp, Gll^Fp, Gll^Fp, Gll^Fp, Gs^Fms, Gs^Fms, Gs^Fms, Gs^Fms, Gs^Fms, Gs^Fms, Hh, Hh, Hh, Gg, Hh
