Ms, Ms, Ms, Ms, Ms, Ms, Ms, Ms, Ms, Ms, Ms, Ms, Ms, Ms, Ms, Ms, Ms, Ms, Ms, Ms, Ms, Ms, Ms, Ms, Ms, Ms, Ms, Ms, Ms, Ms, Ms, Ms, Ms, Ms, Ms, Ms, Ms
Ms, Ms, Ms, Ms, Ms, Ms, Ms, Ms, Ms, Ms, Ms, Ms, Ms, Ms, Ms, Ms, Ms, Ms, Ms, Ms, Ms, Ms, Ms, Ms, Ms, Ms, Ms, Ms, Ms, Ms, Ms, Ms, Ms, Ms, Ms, Ms, Ms
Ms, Ms, Ms, Ms, Aa^Fma, Ha, Aa^Fma, Ha, Ha, Ms, Ha, Ha, Aa^Voa, Ha, Ha, Ha, Ha, Ms, Ha, Ha, Ha, Ms, Aa^Fma, Ms, Aa^Fma, Ms, Ha, Ms, Aa^Fma, Ms, Aa^Fma, Ms, Ms, Ms, Ms, Ms, Ms
Ms, Ms, Ai, Aa^Fma, Aa^Fma, Aa^Voa, Aa^Fma, Aa^Fma, Aa^Fma, Ha, Aa^Fma, Aa^Fma, Aa^Fma, Aa^Fma, Aa^Fma, Aa^Fma, Aa^Fma, Ha, Aa^Fma, Ha, Aa^Fma, Aa^Fma, Aa^Fma, Aa^Fma, Aa^Fma, Aa^Voa, Aa^Fma, Aa^Fma, Aa^Fma, Aa^Fma, Aa^Voa, Ha, Aa, Ms, Ms, Ms, Ms
Ms, Ms, Ai, Ai, Aa^Fma, Aa^Fma, Aa^Fma, Aa^Fma, Aa, Aa^Voa, Coa, Coa^Ebn, Coa, Aa, Aa, Aa, Coa, Coa, Coa, Aa^Fma, Aa^Fma, Aa^Fma, Coa, Coa, Coa, Aa^Fma, Aa^Fma, Aa^Fma, Coa, Coa^Ebn, Coa, Aa, Aa, Aa, Ms, Ms, Ms
Ms, Ms, Ai, Ai, Aa^Fma, Aa^Fma, Aa^Voa, Aa, Coa, Rb, Rb, Gd^Vo, Gd^Ecf, Coa, Coa, Coa, Rb, Rb, Rb, Coa, Coa^Ebn, Coa, Rb, Rb, Rb, Coa, Coa, Coa, Gd^Ecf, Gd^Vo, Rb, Rb, Coa, Aa^Voa, Ms, Ms, Ms
Ms, Ms, Ms, Ai, Aa^Fma, Aa^Fma, Aa, Coa, Gd^Vo, Gd, Rb, Gd, Gd, Gd^Vo, Co, Rb, Ko, Ko, Rb, Rb, Rb, Rb, Rb, Ko, Ko, Rb, Co, Gd^Vo, Gd, Gd, Rb, Gd, Gd^Vo, Coa, Ms, Ms, Ms
Ms, Ms, Ms, Ai, Ai, Aa^Fma, Aa, Coa^Ebn, Coa, Gd^Ecf, Rb, Rb, Rb, Gd^Ebn, Rb, Rb, Rb, Rb, Ko, Rb, Ko, Rb, Ko, Rb, Rb, Rb, Rb, Gd^Ebn, Rb, Rb, Rb, Gd^Ecf, Coa, Coa^Ebn, Ms, Ms, Ms
Ms, Ms, Ms, Ms, Ai, Aa^Fma, Aa^Fma, Aa, Coa, Gd^Vo, Gd, Rb, Rb, Rb, Rb, Ko, Rb, Co, Co, Ko, Ko, Ko, Co, Co, Rb, Ko, Rb, Rb, Rb, Rb, Gd, Gd^Vo, Coa, Ha, Ms, Ms, Ms
Ms, Ms, Ms, Ms, Ms, Ai, Ai, Aa, Coa, Gd, Gd, Gd^Vo, Gd, Rb, Rb, Ko^Ebn, Rb, Co, Co, Co, Co, Co, Co, Co, Rb, Ko^Ebn, Rb, Rb, Gd, Gd^Vo, Gd, Gd, Coa, Ha, Ms, Ms, Ms
Ms, Ms, Ms, Ms, Ms, Ai, Aa^Fma, Aa, Coa^Ebn, Gd^Vo, Gd, Gd, Gd^Vo, Gd, Rb, Rb, Rb, Rb, Rb, Rb, Rb, Rb, Rb, Rb, Rb, Rb, Rb, Gd, Gd^Vo, Gd, Gd, Gd^Vo, Coa^Ebn, Ha, Ms, Ms, Ms
Ms, Ms, Ms, Ms, Ms, Ai, Aa^Fma, Aa, Coa, Gd^Ecf, Gd, Gd, Gd, Gd, Rb^Ebn, Rb, Rb, Rb, Rb, Rb, Rb, Rb, Rb, Rb, Rb, Rb, Rb^Ebn, Gd, Gd, Gd, Gd, Gd^Ecf, Coa, Ha, Ms, Ms, Ms
Ms, Ms, Ms, Ms, Ha, Ha, Aa^Fma, Aa, Coa, Gd^Vo, Gd, Gd, Gd, Gd, Gd, Rb, Rb, Rb, Coa^Ebn, Rb, Rb, Rb, Coa^Ebn, Rb, Rb, Rb, Gd, Gd, Gd, Gd, Gd, Gd^Vo, Coa, Ha, Ms, Ms, Ms
Ms, Ms, Ms, Ms, Ha, Ha, Aa^Fma, Aa, Coa^Ebn, Gd, Gd^Vo, Gd, Gd, Gd^Vo, Gd, Rb, Rb, Rb, Coa, Rb, Rb, Rb, Coa, Rb, Rb, Rb, Gd, Gd^Vo, Gd, Gd, Gd^Vo, Gd, Coa^Ebn, Ha, Ha, Ms, Ms
Ms, Ms, Ms, Ms, Ha, Ha, Aa^Fma, Aa, Aa, Coa, Coa, Gd^Ecf, Coa, Coa, Coa, Rb, Coa, Coa, Rb, Rb, Rb, Rb, Rb, Coa, Coa, Rb, Coa, Coa, Coa, Gd^Ecf, Coa, Coa, Aa^Fma, Aa^Fma, Ha, Ha, Ms
Ms, Ms, Ms, Ms, Ms, Ha, Aa^Fma, Aa, Aa, Aa, Aa, Coa^Ebn, Aa, Aa, Aa, Coa, Aa, Aa, Koa^Ebn, Rb, Rb, Rb, Koa^Ebn, Aa, Aa, Coa, Aa, Aa, Aa, Coa^Ebn, Aa, Aa, Aa^Fma, Ha, Ms, Ms, Ms
Ms, Ms, Ms, Ms, Ms, Aa^Fma, Aa^Fma, Aa, Aa, Koa, Aa, Aa, Aa, Koa, Aa, Aa, Aa, Aa, Rb, Rb, Rb, Rb, Rb, Aa, Aa, Aa, Aa, Koa, Aa, Aa, Aa, Koa, Aa^Fma, Ha, Ms, Ms, Ms
Ms, Ms, Ms, Ms, Ms, Ha, Aa^Fma, Aa, Aa^Fma, Aa^Fma, Aa^Fma, Aa, Aa^Fma, Aa^Fma, Aa^Fma, Aa, Aa, Aa^Fma, Koa^Ebn, Rb, Rb, Rb, Koa^Ebn, Aa, Aa, Aa, Aa^Fma, Aa, Aa^Fma, Aa, Aa^Fma, Aa^Fma, Aa^Fma, Aa^Fma, Ms, Ms, Ms
Ms, Ms, Ms, Ms, Aa, Aa^Fma, Aa^Fma, Aa^Fma, Aa^Fma, Aa^Fma, Aa^Fma, Aa^Fma, Aa^Fma, Aa^Fma, Aa, Aa^Fma, Aa^Fma, Aa^Fma, Rb, Rb, Rb, Rb, Rb, Aa, Aa, Aa, Aa^Fma, Aa^Fma, Aa^Fma, Aa^Fma, Aa^Fma, Aa^Fma, Aa^Fma, Ha, Ms, Ms, Ms
Ms, Ms, Ha, Ha, Aa, Aa, Aa^Fma, Aa^Fma, Aa^Fma, Aa^Fma, Aa^Fma, Aa^Fma, Aa^Fma, Aa^Fma, Aa^Fma, Aa^Fma, Koa^Ebn, Rb, Aa, Rb, Rb, Rb, Aa, Rb, Koa^Ebn, Aa^Fma, Aa, Aa^Fma, Aa^Fma, Aa, Aa^Fma, Aa, Aa^Fma, Ha, Ha, Ms, Ms
Ha, Ha, Ha, Ha, Aa, Aa, Aa, Aa^Fma, Aa, Aa^Fma, Aa^Fma, Aa^Fma, Aa^Fma, Aa^Fma, Aa^Fma, Aa^Fma, Aa^Fma, Aa^Fma, Aa, Rb, Rb, Rb, Aa, Aa, Aa, Aa, Aa^Fma, Aa^Fma, Aa^Fma, Aa^Fma, Aa, Aa^Fma, Aa^Fma, Ha, Ms, Ms, Ms
Ai, Ha, Ai, Ai, Ai, Aa, Aa, Aa, Aa, Aa^Fma, Aa^Fma, Aa^Fma, Aa, Aa^Fma, Aa^Fma, Aa^Fma, Aa^Fma, Aa^Fma, Aa, Rb, Rb, Rb, Aa, Aa, Aa, Aa^Fma, Aa^Fma, Aa^Fma, Aa^Fma, Aa^Fma, Aa^Fma, Aa^Fma, Aa^Fma, Ha, Ms, Ms, Ms
Ha, Ai, Ha, Ai, Ai, Ai, Ai, Ai, Ai, Aa^Fma, Aa, Aa^Fma, Aa^Fma, Aa^Fma, Aa^Fma, Aa, Aa, Aa, Aa, Rb, Rb, Rb, Aa, Aa, Aa, Aa, Aa^Fma, Aa^Fma, Aa^Fma, Aa^Fma, Aa, Aa^Fma, Ha, Ha, Ms, Ms, Ms
Ai, Ha, Ha, Ha, Ha, Ai, Ai, Ai, Ai, Ai, Ai, Aa^Fma, Aa, Aa^Fma, Aa^Fma, Aa^Fma, Aa, Aa, Aa, Rb, Rb, Rb, Aa, Aa, Aa, Aa^Fma, Aa^Fma, Aa^Fma, Aa, Aa^Fma, Aa, Aa^Fma, Ha, Ha, Ha, Ms, Ms
Ms^Xm, Ms^Xm, Ms^Xm, Ha, Ha, Ha, Ha, Ai, Ai, Ai, Ai, Ai, Aa^Fma, Aa, Aa^Fma, Aa^Fma, Aa^Fma, Aa^Fma, Aa, Rb, Rb, Rb, Aa, Aa, Aa^Fma, Aa^Fma, Aa^Fma, Aa, Aa^Fma, Aa^Fma, Aa, Aa^Fma, Ha, Ha, Ha, Ms, Ms
Ms^Xm, Ms^Xm, Ms^Xm, Ms^Xm, Ms^Xm, Ms, Ha, Ha, Ai, Ai, Ai, Ai, Aa, Aa^Fma, Aa^Fma, Aa^Fma, Aa^Fma, Aa^Fma, Aa, Rb, Rb, Rb, Aa, Aa, Aa^Fma, Aa, Aa, Aa^Fma, Aa^Fma, Aa, Aa, Aa^Fma, Ur^Ii, Xu, Xu, Ms, Ms
Ms, Ms^Xm, Ms^Xm, Ms^Xm, Ms^Xm, Ms, Ms, Ha, Ha, Ai, Ai, Ai, Aa, Aa, Aa, Aa, Aa^Fma, Aa^Fma, Aa, Rb, Rb, Rb, Aa, Aa, Aa, Aa, Aa, Aa, Aa, Aa, Ha, Xu, Xu, Ur, Ur, Xu, Xu
Ms^Xm, Ms^Xm, Ms^Xm, Ms^Xm, Ms^Xm, Ms^Xm, Ms, Ha, Ha^Vhha, Ai, Ai, Ai, Ai, Aa, Aa, Aa, Aa^Fma, Aa^Fma, Aa, Rb, Rb, Rb, Ha, Ha, Ha, Aa, Ms, Aa, Ms, Ms, Ms, Ms, Xu, Uu^Vud, Ur, Uu^Vud, Ur
Ms^Xm, Ms^Xm, Ms^Xm, Ms^Xm, Ms, Ms, Ha, Ha, Ai, Ai, Ai, Ai, Ai, Ai, Aa^Fma, Aa, Aa, Aa, Aa, Rb, Rb, Rb, Aa^Fma, Ha, Ms, Ms, Ms^Xm, Ms^Xm, Ms^Xm, Ms^Xm, Ms^Xm, Xu, Ur^Ii, Ur, Xu, Ur, Xu
Ms^Xm, Ms^Xm, Ms, Ms, Ms, Ha, Ha, Ha, Ai, Ai, Ai, Ai, Aa^Fma, Aa^Fma, Aa^Fma, Aa, Aa, Aa, Rb, Rb, Rb, Rb, Ha, Ha, Ms, Ms^Xm, Ms^Xm, Ms^Xm, Ms^Xm, Ms^Xm, Aa^Voa, Ha, Koa, Xu, Aa^Voa, Xu, Ms
Ms, Ms, Ha, Ms, Ha, Ha, Ai, Ai, Aa^Fma, Ai, Aa^Fma, Ai, Aa^Fma, Aa^Fma, Aa^Fma, Aa^Fma, Aa, Aa, Rb, Rb, Rb, Rb, Aa^Fma, Ha, Ms^Xm, Ms^Xm, Ms^Xm, Ms^Xm, Ms, Ha, Aa^Voa, Koa, Koa, Koa, Ha, Aa^Voa, Aa^Fma
Ms, Ha, Ha, Ha, Aa, Aa, Aa^Fma, Aa^Fma, Aa^Fma, Aa^Fma, Aa^Fma, Aa^Fma, Aa^Fma, Aa^Fma, Aa^Fma, Aa^Fma, Re, Rb, Re, Rb, Re, Aa^Fma, Re, Aa, Re, Ms^Xm, Re, Ms, Re, Ha, Ha, Ha, Ha, Ha, Re, Aa^Fma, Re
Ha, Ha, Re, Aa, Re, Aa^Fma, Re, Aa^Fma, Aa^Fma, Aa^Fma, Re, Aa^Fma, Aa^Fma, Aa^Fma, Re, Re, Aa, Re, Aa, Re, Aa^Fma, Re, Aa^Fma, Re, Ms, Re, Ms, Re, Re, Re, Re, Re, Re, Re, Re, Re, Ha
Re, Re, Aa^Fma, Re, Aa^Fma, Re, Aa^Fma, Re, Re, Re, Ha, Re, Re, Re, Aa^Fma, Aa^Fma, Aa, Re, Aa, Aa, Aa, Ms, Ms, Ms, Ms, Ms, Ms^Xm, Ms^Xm, Ms^Xm, Ms, Ms^Xm, Ms, Ms^Xm, Ms, Ms, Ha, Ms^Xm
Ha, Ha, Aa^Fma, Aa^Fma, Aa^Fma, Aa^Fma, Aa^Fma, Aa^Fma, Aa^Fma, Aa^Fma, Ms, Ms, Ms, Ms, Ha, Aa, Aa, Re, Aa, Aa, Ai, Aa^Fma, Aa^Fma, Ms, Aa^Fma, Ms, Ms, Ms^Xm, Ms^Xm, Ms^Xm, Ms^Xm, Ms^Xm, Ms^Xm, Ms^Xm, Ms^Xm, Ms^Xm, Ha
Ha, Ha, Aa^Fma, Aa^Fma, Aa^Fma, Aa^Fma, Aa^Fma, Aa^Fma, Aa^Fma, Aa^Fma, Ha, Ha, Ha, Ms, Ms, Aa, Ai, Re, Ai^Bw\, Ai, Ai, Ai, Ai, Ai, Ai, Ai, Ai, Ms, Ms, Ms^Xm, Ms, Ms, Ms, Ms^Xm, Ms^Xm, Ms^Xm, Ms^Xm
Ha, Aa^Fma, Aa^Fma, Aa^Fma, Ai, Aa^Fma, Ai, Aa^Fma, Ai, Ha, Ai, Ha^Vhha, Ha, Ha, Ai, Ai, Ai, Ai, Ai, Ai^Bw\, Re, Ai, Aa^Fma, Ai, Aa^Fma, Ai, Ai, Ai, Ai, Ms, Ha, Ms, Ai, Ms, Ms, Ms^Xm, Ms
Ai, Ai, Ai, Ai, Ai, Ai, Ai, Ai, Ai, Ai, Ai, Ai, Ai, Ai, Ai, Ai, Aa^Fma, Aa^Fma, Aa^Fma, Aa, Re, Aa, Aa, Aa^Fma, Aa^Fma, Aa^Fma, Aa^Fma, Aa^Fma, Aa^Fma, Aa^Fma, Aa^Fma, Ai, Ai, Ai, Ms, Ms^Xm, Ms^Xm
Ms, Ai, Ha, Ha^Vhha, Ha, Ai, Aa^Fma, Ai, Aa^Fma, Ai, Ai, Ai, Aa^Fma, Ai, Aa^Fma, Aa^Fma, Aa^Fma, Aa^Fma, Aa^Fma, Aa, Aa, Re, Re, Aa^Fma, Aa^Fma, Aa^Fma, Aa^Fma, Aa^Fma, Aa^Fma, Aa^Fma, Ai, Ai, Aa^Voa, Ai, Ms, Ms, Ms^Xm
Ms, Ha, Ms, Ha, Ms, Aa^Fma, Aa^Fma, Aa^Fma, Aa^Fma, Aa^Fma, Ai, Aa^Fma, Ha, Ha, Ms, Ha, Ha, Ha, Ha, Aa^Fma, Aa^Fma, Aa, Aa, Re, Re, Aa, Aa^Fma, Aa^Fma, Aa^Fma, Ai, Ai, Cte^Ebn, Kte, Ha, Ms^Xm, Ms, Ms
Ms, Ms, Ms, Ms, Ms, Ms, Ms, Ha, Ha, Ha, Ai, Ha, Ms, Ms, Ms, Ha, Ha, Ha, Ha, Aa^Fma, Aa^Fma, Aa^Fma, Aa^Fma, Aa, Re, Aa, Aa, Aa^Fma, Aa^Fma, Aa^Fma, Ai, Cte^Ebn, Ms^Xm, Ms^Xm, Ms^Xm, Ms^Xm, Ms^Xm
Ms^Xm, Ms^Xm, Ms^Xm, Ms, Ms, Ms, Ms, Ms, Ms, Ms, Ms, Ha, Ms, Ms, Ms, Ha, Aa^Fma, Aa^Fma, Aa^Fma, Aa^Fma, Aa^Fma, Aa^Fma, Aa^Fma, Aa^Fma, Aa^Fma, Re, Re, Aa, Aa^Fma, Aa^Fma, Ai, Ha, Ms, Ms, Ms, Ms^Xm, Ms^Xm
Md^Xm, Ms^Xm, Ms^Xm, Ms^Xm, Ms^Xm, Ms^Xm, Ms^Xm, Ms, Ms, Ms, Ms, Ms, Ms, Ms, Ha, Ha, Aa^Fma, Aa^Fma, Aa^Fma, Aa^Fma, Aa^Fma, Aa^Fma, Ai, Aa^Fma, Aa^Fma, Aa, Aa, Re, Aa, Aa^Fma, Aa, Ha, Ms, Ms, Ms, Ms^Xm, Ms^Xm
Md^Xm, Md^Xm, Md^Xm, Md^Xm, Md^Xm, Ms^Xm, Ms^Xm, Ms^Xm, Ms^Xm, Ms, Ms, Ms, Ms, Ms, Ms, Ai, Ai, Ai, Ai, Ai, Ai, Ai, Aa^Fma, Ai, Ww, Aa, Gll^Fmw, Re, Re, Gll^Fmw, Aa, Ha, Ms, Ms, Ms, Ms, Ms^Xm
Gg, Mm, Mm, Mm, Mm, Md^Xm, Md^Xm, Ms^Xm, Ms^Xm, Ms^Xm, Ms^Xm, Ms, Ms, Ms, Ms, Ha, Ha, Aa^Fma, Ha, Aa^Fma, Aa^Fma, Aa^Fma, Aa^Fma, Ai, Ww, Gll^Fmw, Gll^Fmw, Gll^Fmw, Re, Gll^Fmw, Gll^Fmw, Ha, Mm, Mm, Mm, Ms, Mm
Gll^Fp, Gll^Fp, Gll^Fp, Gll^Fp, Gll^Fp, Mm, Mm, Md^Xm, Md^Xm, Ms^Xm, Ms^Xm, Ms^Xm, Ms^Xm, Ms, Ms^Xm, Ms, Mm, Mm, Mm, Ha, Md^Xm, Mm, Md^Xm, Mm, Mm, Ww, Mm, Gll^Fmw, Gll^Fmw, Re, Re, Ha, Ha, Mm, Mm, Mm, Mm
Ww, Gll^Fp, Ww, Gll^Fp, Gll^Fp, Gll^Fp, Gll^Fp, Md^Xm, Mm, Md^Xm, Md^Xm, Ms^Xm, Md^Xm, Ms^Xm, Md^Xm, Md^Xm, Md^Xm, Md^Xm, Mm, Md^Xm, Mm, Mm, Mm, Md^Xm, Mm, Ww, Mm, Mm, Mm, Gll^Fmw, Gll^Fmw, Re, Gll^Fmw, Mm, Mm, Mm, Mm
Ww, Ww, Ww, Ww, Ww, Gll^Fp, Gll^Fp, Gll^Fp, Mm, Mm, Mm, Md^Xm, Md^Xm, Md^Xm, Md^Xm, Md^Xm, Mm, Mm, Mm, Mm, Ww, Mm, Ww, Mm, Ww, Ww, Ww, Mm, Mm, Mm, Mm, Re, Re, Gll^Fmw, Mm, Mm, Mm
Ww, Ww, Ww, Ww, Ww, Ww, Gll^Fp, Gll^Fp, Gll^Fp, Mm, Mm, Md^Xm, Md^Xm, Md^Xm, Md^Xm, Md^Xm, Mm, Mm, Mm, Mm, Ww, Ww, Ww, Ww, Ww, Ww, Ww^Edt, Ww, Hh, Mm, Mm, Mm, Hh, Re, Mm, Mm, Mm
Ww, Ww, Ww, Ww, Ww, Ww, Gll^Fp, Gll^Fp, Gll^Fp, Mm, Mm, Md^Xm, Md^Xm, Md^Xm, Md^Xm, Mm, Mm, Mm, Mm, Mm, Ww, Ww, Ww, Ww, Hh, Ww, Hhd^Vhhr, Hh, Gll^Fdw, Hh, Hh, Hh, Hh, Re, Mm, Mm, Mm
Gll^Fp, Ww, Ww, Ww, Gll^Fp, Gll^Fp, Gll^Fp, Gll^Fp, Mm, Mm, Md^Xm, Md^Xm, Md^Xm, Md^Xm, Md^Xm, Mm, Hhd^Vhhr, Mm, Hh, Ww, Hh, Hh, Hh, Hh, Gll^Fdw, Hh^Edb, Hh^Dr, Gll^Fdw, Re^Edb, Re, Re, Gll^Fdw, Re, Re, Mm, Mm, Mm
Gll^Fp, Gll^Fp, Hh, Gll^Fp, Hh, Gll^Fp, Hh, Mm, Mm, Mm, Md^Xm, Md^Xm, Md^Xm, Md^Xm, Mm, Mm, Hh^Dr, Gd^Edb, Gd^Edb, Hh, Gll^Fdw, Gll^Fdw, Gd^Dr, Gll^Fdw, Gll^Fdw, Re, Re^Edb, Re, Re, Re, Re, Re, Re, Re, Mm, Mm, Mm
Gll^Fp, Gll^Fp, Md, Hh, Md, Hh, Mm, Mm, Mm, Md^Xm, Mm, Md^Xm, Mm, Md^Xm, Md^Xm, Hh, Re, Gll^Fdw, Gll^Fdw, Gd^Edb, Re, Re, Re, Re, Re, Re, Gll^Fdw, Re^Edb, Gll^Fdw, Re, Hh, Gll^Fdw, Gll^Fdw, Re, Mm, Mm, Mm
Md, Md, Md, Md, Mm, Mm, Md^Xm, Md^Xm, Md^Xm, Md^Xm, Md^Xm, Md^Xm, Md^Xm, Md^Xm, Mm, Mm, Re, Re, Re, Re, Re^Edb, Re, Gll^Fdw, Re, Hh^Edb, Gll^Fdw, Hh, Hh, Ww, Hh, Ww, Hh, Hh, Gd^Fetd, Hh, Mm, Mm
Md, Md, Md^Xm, Md^Xm, Md^Xm, Md^Xm, Md^Xm, Md^Xm, Mm, Mm, Mm, Mm, Mm, Mm, Ce, Ket, Re, Mm, Mm, Hh, Hh, Gll^Fdw, Hh, Gd^Dr, Hhd^Vhhr, Ww^Edt, Ww, Ww, Mm, Ww, Mm, Hh, Hh, Hh, Hh, Mm, Mm
Md^Xm, Md^Xm, Md^Xm, Md^Xm, Mm, Mm, Mm, Mm, Mm, Mm, Mm, Mm, Ce, Ke, Re, Hhd^Edt, Re, Ket, Mm, Mm, Mm, Hh, Mm, Mm, Mm, Mm, Mm, Mm, Mm, Mm, Md^Xm, Mm, Md^Xm, Mm, Mm, Mm, Mm
Md^Xm, Md^Xm, Md^Xm, Mm, Mm, Mm, Mm, Mm, Ww^Es, Mm, Ww, Ww^Es, Ket, Re, Hhd, Re, Ke, Ce, Mm, Mm, Md^Xm, Mm, Md^Xm, Md^Xm, Md^Xm, Md^Xm, Md^Xm, Md^Xm, Md^Xm, Md^Xm, Md^Xm, Md^Xm, Md^Xm, Md^Xm, Md^Xm, Md^Xm, Mm
Md^Xm, Md^Xm, Mm, Mm, Mm, Mm, Mm, Ww^Es, Ww, Ww, Gs^Fms, Gll^Ebn, Re, Re, Ket, Ce, Mm, Mm, Md^Xm, Md^Xm, Mm, Md^Xm, Mm, Mm, Wwr, Mm, Mm, Mm, Mm, Mm, Mm, Md^Xm, Rr^Vd, Md^Xm, Md^Xm, Md^Xm, Mm
Mm, Mm, Mm, Mm, Mm, Mm, Ww, Ww, Gg^Es, Gg, Re, Re, Gll^Fp, Gll^Ebn, Mm, Mm, Md^Xm, Md^Xm, Mm, Mm, Ww, Mm, Ww, Ww, Ww, Ww, Ww, Mm, Ww, Mm, Gs^Fms, Mm^Ii, Rb, Mm^Ii, Mm, Md^Xm, Md^Xm
Mm, Mm, Mm, Mm, Mm, Mm, Ww, Gg, Re, Re, Gg, Gll^Fmw, Gll^Fp, Mm, Md^Xm, Md^Xm, Mm, Mm, Ww, Ww, Gs^Fms, Ww, Re, Gs^Fms, Re, Gs^Fms, Re, Ww, Re, Ww, Re, Gs^Fms, Gs^Fms, Rb, Wwr, Mm, Md^Xm
Mm, Mm, Mm, Mm, Ww, Ww, Gg, Re, Re, Gg, Ww, Ww^Es, Mm, Mm, Md^Xm, Md^Xm, Mm, Mm, Ww, Gs^Fms, Re, Re, Gs^Fms, Re, Gs^Es, Re, Gs^Fms, Re, Gll^Fp, Re, Gll^Fp, Re, Re, Gs^Fms, Ww, Mm, Wwr
Mm, Mm, Mm, Mm, Ww, Gg^Es, Re, Re, Gg^Es, Ww, Mm, Mm, Mm, Md^Xm, Mm, Mm, Ww, Ww, Re, Re, Gs^Fms, Gs^Fms, Gll^Fp, Gll^Fp, Mm, Gll^Fp, Mm, Gll^Fp, Mm, Gll^Fp, Gs^Fms, Gs^Efm, Re, Gs^Fms, Ww, Ww, Mm
Mm, Mm, Mm, Wwr, Ww, Gg, Re, Gg, Ww, Ww, Mm, Mm, Mm, Mm, Ww, Ww, Gs^Fms, Re, Gs^Fms, Gs^Fms, Gs^Fms, Gll^Fp, Mm, Mm, Mm, Mm, Md^Xm, Md^Xm, Md^Xm, Mm, Mm, Ket, Gs^Fms, Re, Ww, Mm, Mm
Mm, Mm, Mm, Ww, Ww, Gg, Re, Gg, Ww, Ww, Mm, Mm, Mm, Ww, Ww, Gs^Fms, Re, Re, Gll^Fp, Gll^Fp, Mm, Mm, Md^Xm, Md^Xm, Md^Xm, Md^Xm, Mm, Mm, Mm, Mm, Gs^Fms, Mm, Gs^Fms, Re, Ww, Mm, Mm
Md^Xm, Mm, Mm, Ww, Gg^Efm, Gg^Efm, Gg^Efm, Re, Gg^Efm, Ww, Ww, Mm, Ww, Ww, Re, Re, Mm, Mm, Mm, Mm, Md^Xm, Md^Xm, Mm, Mm, Mm, Mm, Mm, Mm, Gs^Fms, Gs^Fms, Gs^Fms, Gs^Fms, Re, Re, Ww, Mm, Mm
Md^Xm, Mm, Mm, Ww, Gg^Efm, Gg^Efm, Gg^Efm, Re, Re, Gg^Efm, Gll^Fp, Ww, Gg, Re, Re, Mm, Mm, Mm, Md^Xm, Md^Xm, Ww, Ww, Mm, Mm, Gs^Fms, Mm, Gs^Fms, Gs^Fms, Gs^Fms, Gs^Fms, Re, Re, Gg, Ww, Mm, Mm, Mm
Md^Xm, Mm, Mm, Ww, Ww, Gll, Ww, Gg^Efm, Re, Gll, Re, Gg, Re, Re, Mm, Mm, Mm, Md^Xm, Md^Xm, Ww, Mm, Mm, Gs^Fms, Gs^Fms, Gs^Fms, Gs^Fms, Re, Gs^Fms, Re, Re, Gg^Efm, Gs^Fms, Ww, Ww, Mm, Mm, Mm
Md^Xm, Mm, Ww, Ww, Mm, Ww, Mm, Ww, Ww, Re, Ww, Re, Ww, Ww, Mm, Mm, Mm, Md^Xm, Ww, Ww, Mm, Mm, Re, Re, Re, Re, Gs^Fms, Re, Gg^Efm, Gg^Efm, Ww, Ww, Ww, Wwr, Mm, Mm, Mm
Md^Xm, Md^Xm, Md^Xm, Md^Xm, Md^Xm, Mm, Mm, Mm, Mm, Ww, Ww, Ww, Mm, Ww, Mm, Mm, Md^Xm, Md^Xm, Ww, Mm, Gll^Fp, Re, Gg, Gg^Es, Gg, Gs^Fms, Gs^Fms, Gg, Ww, Ww, Mm, Mm, Md^Xm, Mm, Md^Xm, Mm, Md^Xm
Md^Xm, Md^Xm, Md^Xm, Md^Xm, Md^Xm, Md^Xm, Md^Xm, Mm, Md^Xm, Mm, Mm, Mm, Mm, Mm, Mm, Mm, Md^Xm, Ww, Ww, Gll^Fp, Gll^Fp, Re, Gg^Efm, Ww^Ewl, Ww, Ww, Ww, Ww, Mm, Mm, Md^Xm, Md^Xm, Hhd, Md^Xm, Mm, Md^Xm, Md^Xm
Md^Xm, Md^Xm, Md^Xm, Md^Xm, Mm, Mm, Mm, Md^Xm, Md^Xm, Md^Xm, Md^Xm, Mm, Md^Xm, Mm, Md^Xm, Md^Xm, Ww, Ww, Ww, Gll^Fp, Gs^Fms, Re, Re, Gs^Fms, Ww, Ww, Mm, Mm, Md^Xm, Md^Xm, Mm, Mm, Gll^Fmw, Mm, Mm, Mm, Md^Xm
Mm, Md^Xm, Mm, Mm, Mm, Mm, Mm, Ww, Ww, Ww, Ww, Md^Xm, Ww, Md^Xm, Ww, Ww, Mm, Ww, Ww, Gs^Fms, Gs^Fms, Gs^Fms, Re, Re, Gs^Fms, Ww, Mm, Mm, Mm, Mm, Gll^Fmw, Gll^Fmw, Gd^Fetd, Gll^Fp, Mm, Mm, Mm
Mm, Mm, Mm, Hh^Vhh, Gs^Wm, Mm, Ww, Ww, Ww^Ewf, Mm, Mm, Ww, Mm, Ww, Mm, Mm, Gg, Ww, Ww, Re, Re, Re, Gs^Fms, Re, Gll^Fp, Ww, Gll^Fmw, Mm, Gll^Fp, Mm, Gll^Fp, Gll^Fp, Gll^Fmw, Gll^Fp, Mm, Mm, Mm
Mm, Mm, Mm, Gs^Ecf, Gs^Fds, Rb^Gvs, Rb^Gvs, Ww^Ewf, Gs^Fms, Re, Re, Mm, Re, Mm, Re, Gg, Re, Ww, Ww^Bw/, Re, Gll^Fmw, Gs^Fms, Gll^Fmw, Re, Rb, Gll^Fp, Gll^Fp, Gll^Fp, Gll^Fp, Gll^Fp, Gll^Fp, Gll^Fp, Gll^Fp, Gll^Fp, Mm, Mm, Mm
Mm, Mm, Mm, Gs^Fds, Gs^Fds, Gs^Fms, Gs^Fds, Gs^Fms, Gs^Fds, Gs^Fms, Gg, Re, Gg, Re, Gg, Re, Ww, Re, Mm, Hhd, Mm, Mm, Mm, Mm, Mm, Rb, Rb, Gll^Fp, Gs^Fms, Gll^Fp, Gs^Fms, Gll^Fp, Gll^Fp, Mm, Mm, Mm, Mm
Md^Xm, Mm, Mm, Gs^Fds, Mm, Mm, Mm, Mm, Mm, Mm, Mm, Mm, Mm, Gg, Ww, Ww, Md^Xm, Ww, Md^Xm, Md^Xm, Md^Xm, Mm, Mm, Mm, Mm, Gs^Fms, Gs^Fms, Rb, Gs^Fms, Gs^Fms, Gs^Fms, Gll^Fp, Gll^Fp, Gll^Fp, Mm, Mm, Mm
Md^Xm, Md^Xm, Md^Xm, Md^Xm, Md^Xm, Md^Xm, Md^Xm, Md^Xm, Md^Xm, Md^Xm, Md^Xm, Md^Xm, Md^Xm, Md^Xm, Md^Xm, Md^Xm, Md^Xm, Md^Xm, Mm, Md^Xm, Md^Xm, Md^Xm, Md^Xm, Mm, Mm, Gs^Fms, Gs^Fms, Rb, Gs^Fms, Gs^Fms, Ww, Gll^Fp, Gll^Fp, Gll^Fp, Mm, Mm, Ww
Mm, Mm, Mm, Mm, Mm, Mm, Mm, Mm, Mm, Mm, Mm, Mm, Mm, Mm, Mm, Mm, Mm, Mm, Mm, Mm, Mm, Md^Xm, Md^Xm, Md^Xm, Md^Xm, Hhd, Gs^Fms, Rb, Gs^Fms, Gs^Fms, Ww, Ww, Ww, Gll^Fp, Ww, Ww, Mm
Gll^Fp, Mm, Gll^Fp, Gll^Fp, Gll^Fp, Gll^Fp, Gll^Fp, Mm, Mm, Mm, Mm, Mm, Gll^Fp, Mm, Gll^Fp, Mm, Gll^Fp, Gll^Fp, Gll^Fp, Mm, Mm, Mm, Mm, Md^Xm, Md^Xm, Mm, Hhd^Em, Rb, Gs^Fms, Ww, Ww, Ww, Ww, Ww, Mm, Mm, Mm
Gll^Fp, Gll^Fp, Gll^Fp, Gll^Fp, Gll^Fp, Gll^Fp, Gll^Fp, Gll^Fp, Gll^Fp, Gll^Fp, Gll^Fp, Gll^Fp, Gll^Fp, Gll^Fp, Gll^Fp, Gll^Fp, Gll^Fp, Gll^Fp, Gll^Fp, Gll^Fp, Hhd^Em, Mm, Mm, Mm, Mm, Md^Xm, Mm, Rb, Gs^Es, Gs^Fms, Ww^Bw/, Ww, Ww, Gll^Fp, Mm, Mm, Mm
Gll^Fp, Gll^Fp, Gll^Fp, Gll^Fp, Gll^Fp, Gll^Fp, Gll^Fp, Gll^Fp, Gll^Fp, Gll^Fp, Gll^Fp, Gll^Fp, Gll^Fp, Gll^Fp, Ss, Ss, Ss, Ss, Ss^Em, Ss, Rb, Rb, Rb, Mm, Mm, Md^Xm, Md^Xm, Rb, Rb, Gs^Fms, Gs^Fms, Ww, Gll^Fp, Gll^Fp, Gll^Fp, Mm, Mm
Gll^Fp, Gll^Fp, Gll^Fp, Gll^Fp, Gll^Fp, Gll^Fp, Ss, Gll^Fp, Gll^Fp, Gll^Fp, Gll^Fp, Gll^Fp, Gll^Fp, Ss, Ss, Ss, Ss, Ss^Em, Rb, Rb, Ss^Em, Gll^Em, Gg, Rb, Rb, Md^Xm, Md^Xm, Rb, Rb, Gs^Fms, Gs^Fms, Gs^Fms, Gll^Fp, Gd^Fetd, Gll^Fp, Mm, Mm
Ss, Gll^Fp, Gll^Fp, Gll^Fp, Ss, Ss, Ss, Ss, Ss, Gll^Fp, Ss, Gll^Fp, Ss, Ss, Ss, Ss, Ss, Ss^Em, Rb, Ss^Em, Ss, Ss, Gll^Em, Rb, Rb, Md^Xm, Md^Xm, Md^Xm, Rb, Gll^Em, Gs^Fms, Gs^Fms, Gll^Fp, Gll^Fp, Gll^Fp, Mm, Mm
Ss, Ss, Ss^Em, Ss, Sm, Ss, Sm, Sm, Sm, Ss, Ss, Ss, Ss^Emf, Ss, Ss, Ss, Ss, Ss, Rb, Ss^Em, Ss^Vhs, Ss, Gll^Em, Gll^Em, Gg^Es, Rb, Rb, Md^Xm, Rb, Gll^Em, Gs^Fms, Gs^Fms, Gll^Fp, Gll^Fp, Mm, Mm, Mm
Ss, Ss, Ss^Em, Sm, Sm, Sm, Sm, Sm, Sm, Sm, Sm, Ss^Em, Ss, Ss, Ss, Ss, Rb, Rb, Ss, Ss, Ss^Emf, Ss, Ss, Gll^Em, Gll^Fp, Rb, Rb, Rb, Rb^Em, Gll^Em, Gs^Ebn, Gs^Fms, Gll^Fp, Gll^Fp, Mm, Mm, Mm
Ss, Ss, Ss, Ss, Ss, Sm, Ss, Ss, Ss, Ss, Ss, Ss, Ss, Ss, Ss, Rb, Rb, Ss^Em, Ss^Em, Ss^Emf, Ss, Ss, Ss, Gll^Em, Gll^Em, Gll^Fp, Gll^Fp, Gll^Fp, Gs^Fms, Gs^Fms, Ce, Gs^Fms, Gd^Vo, Gll^Fp, Mm, Mm, Mm
Ss, Ss, Ss, Ss, Ss, Ss, Ss, Ss^Vhs, Ss, Ss, Ss, Ss, Rb, Ss, Rb, Rb, Ss^Em, Ss^Em, Ss, Ss, Sm, Sm, Ss, Ss, Ss, Gll^Em, Gll^Fp, Gll^Fp, Gs^Fms, Ce, Ke, Ce, Gll^Fp, Gll^Fp, Mm, Mm, Mm
Rb, Ss, Rb, Ss, 1 Rb, Ss, Rb, Ss, Rb, Ss, Rb, Rb, Rb, Rb, Rb, Ss, Ss, Ss, Ss, Ss, Sm, Sm, Ss, Ss, Gll^Fp, Ss, Gll^Fp, Gs^Fms, Gll^Ebn, Ce, Ce, Ce, Gll^Ebn, Gll^Fp, Mm, Mm, Mm
Rb, Rb, Rb, 2 Rb, Ss, Rb, Ss, Rb, Ss, Rb, Ss, Ss, Ss, Ss, Ss, Rb, Rb, Ss, Ss, Ss, Ss, Ss, Gll^Fp, Gll^Fp, Gll^Fp, Gll^Fp, Gll^Fp, Gll^Fp, Gll^Fp, Gll^Fp, Gd^Vo, Gll^Fp, Gd^Fetd, Gll^Fp, Mm, Mm, Mm
Ss, Ss, Ss, Ss, Ss^Emf, Ss^Em, Ss, Ss, Ss, Ss, Ss, Ss, Ss, Ss^Vhs, Ss, Ss, Ss, Rb, Ss, Ss, Ss, Gll^Fp, Gll^Fp, Gll^Fp, Gll^Fp, Gll^Fp, Gll^Fp, Gll^Fp, Gll^Fp, Gll^Fp, Gll^Fp, Gll^Fp, Hhd, Hhd, Mm, Mm, Mm
Ss, Ss, Ss, Ss, Ss^Em, Ss^Em, Sm, Ss^Em, Sm, Ss, Ss, Ss^Em, Ss^Em, Ss^Em, Ss, Ss, Ss, Rb, Rb, Ss, Ss, Gll^Fp, Gll^Fp, Gll^Fp, Gll^Fp, Gll^Fp, Mm, Gll^Fp, Mm, Gll^Fp, Mm, Mm, Mm, Mm, Mm, Md^Xm, Mm
Gs^Fms, Ss, Ss, Ss, Ss, Sm, Sm, Sm, Sm, Sm, Sm, Ss, Ss, Ss, Ss, Ss, Ss, Ss, Rb, Ss, Ss, Gll^Fp, Gll^Fp, Gll^Fp, Mm, Mm, Mm, Mm, Mm, Mm, Mm, Mm, Mm, Mm, Mm, Mm, Mm
