Gs^Fds, Gs^Fds, Gs^Fds, Ww, Ww, Ww, Ww, Gg, Gg, Gg, Rrc, Gg^Efm, Gg^Efm, Gs^Fds, Gs^Fds, Gs^Fds, Gs^Fds, Gs^Fds, Gs^Fds, Gg, Gg^Eff, Gg^Eff, Rb^Gvs, Rb^Gvs, Rb^Gvs, Gg^Eff, Gg^Eff, Gg, Gg, Gg, Ww, Ww, Gg, Gg, Gs^Fds, Gs^Fds, Gs^Fds
Gs^Fds, Gs^Fds, Gg^Efm, Gg, Gg, Ww, Ww, Gg, Gg, Gg, Rrc, Gg^Efm, Gg^Vwm, Gg^Efm, Gg, Gs^Fds, Gg, Gs^Fds, Gg^Eff, Gg^Eff, Rb^Gvs, Rb^Gvs, Rb^Gvs, Rb^Gvs, Rb^Gvs, Rb^Gvs, Rb^Gvs, Gg^Eff, Gg^Eff, Ww, Gg, Gg, Gg, Gs^Fds, Gs^Fds, Gs^Fds, Gg^Eff
Gs^Fds, Gs^Fds, Gg^Efm, Gg^Efm, Gg^Efm, Ww, Ww, Ww, Ch, Gg, Rrc, Gg^Efm, Gg^Efm, Gg^Efm, Gg^Efm, Gg, Gg^Eff, Gg^Eff, Rb^Gvs, Rb^Gvs, Rb^Gvs, Rb^Gvs, Rb^Gvs, Rb^Gvs, Rb^Gvs, Rb^Gvs, Gg^Eff, Gg^Eff, Ww, Ww, Gg, Gg, Gg, Gs^Fds, Gg^Eff, Gg^Eff, Rb^Gvs
Gs^Fds, Gs^Fds, Gg^Efm, Gg^Efm, Gg^Efm, Gg, Ww, Ww, Kh, Ch, Gg, Gg^Efm, Gg^Efm, Gg^Efm, Gg^Eff, Gg^Eff, Rb^Gvs, Rb^Gvs, Rb^Gvs, Rb^Gvs, Rb^Gvs, Rb^Gvs, Rb^Gvs, Rb^Gvs, Gg^Eff, Gg^Eff, Gg, Ww, Gg, Gg, Gg, Gg, Gg^Eff, Gg^Eff, Rb^Gvs, Rb^Gvs, Rb^Gvs
Gg, Gg, Gg, Gg^Efm, Ch, Ch, Ww^Bsb/, Ww^Bsb/, Ww, Ch, Gg, Gg, Gg^Eff, Gg^Eff, Rb^Gvs, Rb^Gvs, Rb^Gvs, Rb^Gvs, Rb^Gvs, Rb^Gvs, Rb^Gvs, Rb^Gvs, Gg^Eff, Gg^Eff, Ch, Ch, Ww, Ww, Gg, Gg, Gg^Eff, Gg^Eff, Rb^Gvs, Rb^Gvs, Rb^Gvs, Rb^Gvs, Rb^Gvs
Rrc, Gg, Gg, Gg^Efm, Rrc, Kh, Ch, Ww, Ww, Ww, Gg^Eff, Gg^Eff, Rb^Gvs, Rb^Gvs, Rb^Gvs, Rb^Gvs, Rb^Gvs, Rb^Gvs, Rb^Gvs, Rb^Gvs, Gg^Eff, Gg^Eff, Rrc, Rrc, Ch, Kh, Ww^Bsb\, Gg, Ch, Gg^Eff, Gg^Eff, Gs^Vl, Rb^Gvs, Rb^Gvs, Rb^Gvs, Rb^Gvs, Gg^Eff
Gg, Rrc, Rrc, Gg, Rrc, Ch, Gg, Gg, Ww, Ww, Ww, Gg^Eff, Gg^Eff, Rb^Gvs, Rb^Gvs, Rb^Gvs, Rb^Gvs, Rb^Gvs, Gg^Eff, Gg^Eff, Rrc, Rrc, Gg, Gg, Gg, Ww, Gg, Kh, Ch, Gg, Gg, Gg^Eff, Rb, Rb^Gvs, Gg^Eff, Gg^Eff, Gg
Gg, Gg, Gg, Rrc, Rrc, Gg, Rr^Vhc, Gg, Rr^Vhc, Ww, Ww, Ww, Gg, Gg^Eff, Gg^Eff, Gs^Vl, Gg^Eff, Rb, Rb, Gg^Efm, Rrc, Rrc, Gg, Gg, Ww, Ww, Gg, Ch, Gg, Rrc, Rrc, Gg, Rb, Rb, Gg, Gg, Gg
Gs^Fds, Gg, Gg, Rr^Vhc, Gg, Rrc, Rrc, Rrc, Rrc, Gg, Ww, Ww, Gg, Gg, Gg, Gg^Eff, Rr^Vhc, Gg^Efm, Rrc, Rrc, Gg, Rr^Vhc, Gg, Ww, Gg, Gg, Gg, Gg, Gg, Rr^Vhc, Rrc, Rrc, Rr^Vhc, Gg, Gg, Gg, Rrc
Gs^Fds, Gs^Fds, Gs^Fds, Gg, Gg, Rrc, Rr^Vhc, Gg, Gg, Rrc, Ww^Bsb\, Ww, Gg, Gg, Gg, Gg, Rrc, Rrc, Gg^Efm, Gg, Gg, Gg, Ww, Ww, Gg, Gg, Gg, Gg, Rrc, Rrc, Rrc, Gg, Gg, Gg, Rrc, Rrc, Gg
Gs^Fds, Gs^Fds, Gs^Fds, Gg, Rr^Vhc, Rrc, Gg, Gg, Gg, Gg, Ww, Ww^Bsb\, Rrc, Rr^Vhc, Rrc, Rrc, Gg, Gg, Gg^Efm, Gg^Efm, Gg^Efm, Ww, Gg, Gg, Gg, Rr^Vhc, Rrc, Rrc, Rr^Vhc, Gg, Gg, Rrc, Rrc, Rrc, Gg^Vwm, Gg, Gg
Gg, Gs^Fds, Gg, Gg, Gg, Rrc, Gg, Gg, Gg, Gg, Ww, Ww, Gg, Rrc, Rrc, Gg, Ww^Ewf, Gg^Efm, Ww, Ww, Ww, Ww^Ewf, Ww, Gg, Rrc, Rrc, Rr^Vhc, Gg, Gg^Efm, Gg^Efm, Gg^Efm, Gg^Efm, Ch, Gg^Efm, Gg^Efm, Gg^Efm, Gg^Efm
Gg, Gg^Vwm, Gg^Efm, Gg, Gg, Rrc, Rrc, Gg, Gg, Gg, Ww, Ww, Ww, Gg, Ww, Ww^Bsb\, Ww^Bsb\, Ww, Ch, Kh, Ch, Ww, Ww^Bsb/, Ww^Bsb/, Ww, Gg, Gg^Efm, Gg^Efm, Gg^Efm, Gg^Efm, Gg^Efm, Ch, Kh, Ch, Ww, Gg^Efm, Ww
Gs^Fds, Gg^Efm, Gg^Efm, Gg^Efm, Gg^Efm, Rr^Vhc, Gg^Efm, Rrc, Rrc, Gg^Efm, Gg^Efm, Ww, Ww, Ww, Ww, Ww^Ewf, Kh, Rrc, Rrc, Rr^Vhc, Rrc, Rrc, Kh, Ww, Ww, Ww, Ww, Gg^Efm, Ww, Ww, Ww, Ww, Ww^Bsb|, Ww, Ww, Ww, Ww
Gs^Fds, Gs^Fds, Gg^Efm, Gg^Efm, Gg^Efm, Gg^Efm, Gg^Efm, Gg^Efm, Rrc, Gg^Efm, Gg^Efm, Gg^Efm, Ww, Ww^Ewf, Ww, Ww, Ch, Rrc, Kh, Kh, Kh, Rrc, Ch, Ww, Ww, Ww^Ewf, Ww, Ww, Ww, Ww, Ww, Ww, Kh, Ww, Gg^Efm, Ww, Gg^Eff
Gs^Fds, Gs^Fds, Gg, Gg^Efm, Gg, Gg^Efm, Gg, Ch, Kh, Ch, Ww, Ww, Ww, Ww, Kh, Ch, Rrc, Rrc, Kh, Kh, Kh, Rrc, Rrc, Ch, Kh, Ww, Ww, Ww, Gg^Efm, Gg^Efm, Gg^Efm, Ch, Ch, Ch, Gg^Eff, Gg^Eff, Rb^Gvs
Gg, Gg, Gg, Gg, Ww, Gg, Ww, Ch, Ww^Bsb|, Ch, Ww, Ww, Ww^Ewf, Ww, Kh, Rr^Vhc, Rrc, Kh, Kh, Kh, Kh, Kh, Rrc, Rr^Vhc, Kh, Ww, Ww^Ewf, Ww, Gg^Efm, Gg^Efm, Rrc, Rrc, Gg^Eff, Gg^Eff, Rb^Gvs, Rb^Gvs, Rb^Gvs
Ww, Ww, Ww, Ww, Ww, Ww, Ww, Ww, Ww^Bsb|, Ww, Gg^Efm, Ww, Ww, Ww, Ww^Ewf, Ch, Rrc, Rr^Vhc, Kh, Kh, Kh, Rr^Vhc, Rrc, Ch, Ww, Ww, Ww, Ww, Gg, Rrc, Gg^Eff, Gg^Eff, Rb^Gvs, Rb^Gvs, Rb^Gvs, Rb^Gvs, Rb^Gvs
Ww, Ww, Ww, Ww, Gg^Eff, Ww, Gg, Ch, Kh, Ch, Gg^Efm, Gg^Efm, Gg^Efm, Ww, Ww^Bsb/, Ww^Bsb/, Kh, Rrc, Rrc, Kh, Rrc, Rrc, Kh, Ww^Bsb\, Ww^Bsb\, Ww, Gg, Gg, Rrc, Rrc, Gg^Eff, Gg^Eff, Rb^Gvs, Rb^Gvs, Rb^Gvs, Rb^Gvs, Rb^Gvs
Gg, Gg, Gg^Eff, Gg^Eff, Gs^Vl, Gg^Eff, Gg^Eff, Ch, Ch, Ch, Rr^Vhc, Gg, Rrc, Ww^Bsb/, Ww, Ww^Ewf, Ww, Ch, Ch, Rr^Vhc, Ch, Ch, Ww, Ww^Ewf, Ww, Ww^Bsb\, Rrc, Rrc, Rr^Vhc, Gg^Eff, Gg^Eff, Gs^Vl, Rb^Gvs, Rb^Gvs, Rb^Gvs, Rb^Gvs, Gg^Eff
Gg^Eff, Gg^Eff, Rb^Gvs, Rb^Gvs, Rb^Gvs, Rb^Gvs, Gg^Eff, Gg^Eff, Rr^Vhc, Rrc, Rrc, Rrc, Rb, Gg, Gg^Efm, Ww, Ww, Ww, Ww, Kh, Ww, Ww, Ww, Ww, Gg, Gg, Rr^Vhc, Rrc, Rrc, Gg, Rb, Rb, Gg^Eff, Rb^Gvs, Gg^Eff, Gg^Eff, Gs^Fds
Rb^Gvs, Rb^Gvs, Rb^Gvs, Rb^Gvs, Gg^Eff, Gg^Eff, Rr^Vhc, Gg, Rrc, Rrc, Rr^Vhc, Gg, Gg^Eff, Rb, Rb, Gg^Efm, Gg^Efm, Ww, Ww^Ewf, Ww, Ww, Ww, Gg, Gg, Gg^Eff, Gg^Eff, Gg^Eff, Gg, Rb, Rrc, Rrc, Gg, Rr^Vhc, Gg^Eff, Gg, Gg, Gs^Fds
Rb^Gvs, Rb^Gvs, Rb, Gg^Eff, Gg, Gg, Rrc, Rrc, Rr^Vhc, Gg, Gg^Eff, Gg^Eff, Gs^Vl, Gg^Eff, Rb, Rb, Gg^Efm, Ww, Ww, Ww, Gg, Gg, Gg^Eff, Gg^Eff, Rb^Gvs, Gs^Vl, Rb^Gvs, Rb, Gg^Eff, Rr^Vhc, Gg, Rrc, Rrc, Gg, Rr^Vhc, Gs^Fds, Gs^Fds
Gg^Eff, Gg^Eff, Gg, Rb, Rrc, Rrc, Rr^Vhc, Gg, Gg^Eff, Gg^Eff, Rb^Gvs, Rb^Gvs, Rb^Gvs, Rb^Gvs, Rb^Gvs, Gg^Eff, Gg^Eff, Ww, Gg, Gg, Gg^Eff, Gg^Eff, Rb^Gvs, Rb^Gvs, Rb^Gvs, Rb^Gvs, Rb^Gvs, Rb^Gvs, Rb^Gvs, Gg^Eff, Gg^Eff, Gg, Rr^Vhc, Rrc, 2 Rrc, Gg, Gg
Gg, Rr^Vhc, Rrc, Rrc, Rrc, Gg, Gg^Eff, Gg^Eff, Rb^Gvs, Rb^Gvs, Rb^Gvs, Rb^Gvs, Rb^Gvs, Rb^Gvs, Gg^Eff, Gg^Eff, Ww, Ww, Gg^Eff, Gg^Eff, Rb^Gvs, Rb^Gvs, Rb^Gvs, Rb^Gvs, Rb^Gvs, Rb^Gvs, Rb^Gvs, Rb^Gvs, Rb^Gvs, Rb^Gvs, Rb^Gvs, Gg^Eff, Gg^Eff, Rr^Vhc, Gg, 1 Rrc, Rrc
Rrc, Rrc, Gg, Gg, Gg^Eff, Rrc, Rrc, Rb^Gvs, Rb^Gvs, Rb^Gvs, Rb^Gvs, Rb^Gvs, Gg^Eff, Gg^Eff, Ww, Ww, Gg^Eff, Gg^Eff, Rb^Gvs, Rb^Gvs, Rb^Gvs, Rb^Gvs, Rb^Gvs, Rb^Gvs, Rb^Gvs, Rb^Gvs, Rb^Gvs, Rb^Gvs, Rb^Gvs, Rb^Gvs, Rb^Gvs, Rb^Gvs, Gg^Eff, Gg^Eff, Gg, Gg, Gg
Gg, Gg, Gg^Eff, Gg^Eff, Rb^Gvs, Rb^Gvs, Rb^Gvs, Rrc, Rrc, Rb^Gvs, Gg^Eff, Gg^Eff, Gg, Ww, Ww, Gg^Eff, Gg^Eff, Rb^Gvs, Rb^Gvs, Rb^Gvs, Rb^Gvs, Rb^Gvs, Rb^Gvs, Rb^Gvs, Rb^Gvs, Rb^Gvs, Rb^Gvs, Rb^Gvs, Rb^Gvs, Rb^Gvs, Gg^Eff, Gg^Eff, Gg, Gg, Gs^Fds, Gs^Fds, Gs^Fds
Gg, Gg, Gg, Gg^Eff, Gg^Eff, Rb^Gvs, Rb^Gvs, Rb^Gvs, Gg^Eff, Rrc, Rrc, Gg^Efm, Ch, Ww, Ww, Ww, Gg, Gg^Eff, Gg^Eff, Rb^Gvs, Rb^Gvs, Rb^Gvs, Rb^Gvs, Rb^Gvs, Rb^Gvs, Rb^Gvs, Rb^Gvs, Rb^Gvs, Gg^Eff, Gg^Eff, Gg, Gg, Gg, Gg, Gs^Fds, Gs^Fds, Gs^Fds
Gg, Gg, Gg, Gg^Vwm, Gg^Efm, Gg^Eff, Gg^Eff, Gg^Eff, Gg^Efm, Gg^Efm, Gg^Efm, Ch, Kh, Ch, Ww, Ww, Gg^Efm, Gg^Efm, Gg^Efm, Gg^Eff, Gg^Eff, Rb^Gvs, Rb^Gvs, Rb^Gvs, Rb^Gvs, Rb^Gvs, Gg^Eff, Gg^Eff, Gg, Gg, Gg, Gg, Gg, Gs^Fds, Gs^Fms, Gg^Fet, Gs^Fds
Gg, Gg, Gg, Gg, Gs^Fds, Gg^Efm, Gg^Efm, Gg^Efm, Gg^Efm, Gg^Efm, Gg, Ch, Ww, Ww^Bsb\, Ww^Bsb\, Ww, Ch, Gg^Efm, Gg^Efm, Gg^Efm, Gg^Efm, Gg^Eff, Gg^Eff, Rb^Gvs, Gg^Eff, Gg^Eff, Gg, Gg, Gs^Fds, Gg, Gs^Fds, Gs^Fds, Gs^Fds, Gs^Fds, Gs^Fms, Gs^Fms, Gs^Fds
Gg, Gg, Gs^Fds, Gs^Fds, Gs^Fds, Gs^Fds, Gs^Fds, Gs^Fds, Gg^Efm, Gg^Efm, Ww, Ww, Ww, Ww, Ch, Kh, Ch, Gg^Efm, Gg^Efm, Gg^Efm, Gg^Efm, Gg, Gg, Gg, Gg, Gg, Gs^Fds, Gs^Fds, Gs^Fds, Gs^Fds, Gs^Fds, Gs^Fds, Gs^Fds, Gs^Fds, Gs^Fds, Gs^Fds, Gs^Fds
