Gg, Gg, Gg, Gg, Gg, Gg, Gg, Gg, Gg, Gg, Gg^Efm, Gg^Efm, Gg^Efm, Gg^Efm, Gg^Efm, Hh, Hh, Hh, Hh, Hh, Hh, Hh, Hh, Hh, Hh, Mm, Hh, Mm, Hh, Hh, Hh, Mm, Mm, Mm, Mm, Mm, Mm, Rb, Mm, Mm, Mm, Hh, Mm, Mm, Mm, Mm, Ww, Mm, Mm, Mm, Mm
Gg, Gg, Gg, Gg, Gg, Gd^Vhr, Gg, Gg, Gg, Gg, Gg, Gg, Gg, Gg^Efm, Gg, Gg^Efm, Gg, Gg, Gg, Hh, Gg, Hh, Gg, Hh, Gg, Hh, Hh, Hh, Gg, Hh, Gg, Hh, Gg, Hh, Hh, Hh, Hh, Rb, Hh, Mm, Hh, Mm, Hh, Mm, Mm, Mm, Ww, Mm, Mm, Mm, Mm
Re, Re, Re, Re, Re, Re, Re, Re, Re, Re, Re, Re, Re, Gg, Re, Gg, Gg, Gg, Gg, Gg, Gg, Gg, Gg, Gg, Gg, Gg, Gg, Gg, Gg, Gg, Gg^Efm, Re^Vct, Gg^Ecf, Gg, Gg^Efm, Gg, Rb, Rb, Gg, Gg, Gg, Hh^Vhh, Gg, Hh, Ww, Ww, Hh, Hh, Hh, Mm, Mm
Gg, Re, Re^Vct, Re^Ecf, Ce, Re^Vct, Re^Ecf, Re, Re, Re, Gg, Gg, Gg, Re, Gg, Re, Re, Gg, Re, Gg, Gg, Gg, Gg, Gg, Gd^Vhr, Gg, Gg, Gg, Gg, Gg, Gg, Gg^Efm, Gg^Efm, Gg^Efm, Gg^Efm, Gg^Efm, Rb, Gg^Efm, Gg^Efm, Gg^Efm, Gg^Efm, Gg^Efm, Ww, Ww, Gg, Gg, Gg, Hh, Gg, Hh, Hh
Gg, Re, Re^Ecf, Ke, Ce, Ce, Ce, Re^Vct, Re, Gg, Gg, Gg, Gg^Efm, Gg, Gg, Gg, Gd^Vhr, Re, Gg, Re, Re, Re, Re, Gg, Re, Gg, Gg, Gg, Gg, Gg, Gg, Gg, Gg, Gg, Re, Rb, Gg^Efm, Gg^Efm, Gg^Efm, Gg^Efm, Ww, Ww, Gg^Efm, Gg^Efm, Gg^Efm, Gg^Efm, Gg^Efm, Gg^Efm, Gg, Gg, Gg
Gs^Fds, Re, Re, Ce, Ce, 3 Ke, Ce, Ce, Re^Ecf, Re, Gg, Gg^Efm, Gg^Efm, Gg^Efm, Gg, Gg, Gg, Gg, Gg, Gg, Gg, Gg, Gg, Re, Gg, Re, Re, Re, Re, Gg, Re, Re, Re, Re, Gg, Re, Re, Gg^Efm, Wwr, Ww, Gg^Efm, Gg, Gg^Efm, Gg^Efm, Gg^Efm, Gg^Efm, Gg^Efm, Gg^Efm, Gg^Efm, Gg^Efm, Gg
Gll^Fdw, Re, Re, Re^Vct, Re^Ecf, Ce, Ce, Ke, Re^Vct, Re, Gg, Gg^Efm, Gg, Gg^Efm, Gg^Efm, Gg, Gg, Gg, Gg, Gg, Gg, Gg, Gg, Gg, Gg, Gg, Gg, Gg, Re, Re, Gg^Efm, Gg, Gg, Gg, Gg, Gg, Wwr, Ww^Bw\, Rrc, Gg^Efm, Gg^Efm, Gg, Gg, Gs^Vh, Gg^Efm, Gg^Efm, Gg, Gg^Efm, Gg, Gg, Gg
Gs^Fds, Gll^Fdw, Gll^Fdw, Re, Re, Re^Vct, Re, Re^Ecf, Re, Re, Gll^Fdw, Gg, Gg, Gll^Fdw, Gll^Fdw, Gg, Gll^Fdw, Gg, Gll^Fdw, Gg, Gll^Fdw, Gg, Gll^Fdw, Gg, Gg^Efm, Gg^Efm, Gg, Gg, Re, Gg, Gg^Efm, Gg, Gd^Vhr, Gg, Ww, Ww, Gg, Gg, Gg, Rrc, Rrc, Gg, Rrc, Gg, Rrc, Gg, Rrc, Gg, Gg, Gg, Gg
Gs^Fds, Gs^Fds, Gs^Fds, Gll^Fdw, Gg, Re, Gll^Fdw, Re, Gll^Fdw, Gll^Fdw, Gll^Fdw, Gll^Fdw, Gll^Fdw, Gg, Gll^Fdw, Gll^Fdw, Gll^Fdw, Gll^Fdw, Gll^Fdw, Gll^Fdw, Gll^Fdw, Gll^Fdw, Gll^Fdw, Gg, Gg^Efm, Gg^Efm, Gg^Efm, Gg, Gg, Re, Gg^Efm, Gg^Efm, Gg, Gg, Ww, Gg, Gg, Gg, Gg, Gg, Gg, Rrc, Gg, Rrc, Gg, Rrc, Gg, Rrc, Rrc, Rrc, Rrc
Gs^Fds, Gs^Fds, Gs^Fms, Gll^Fdw, Gg, Gll^Fdw, Gll^Fdw, Gll^Fdw, Gll^Fdw, Gll^Fdw, Gll^Fdw, Gll^Fdw, Gll^Fdw, Gg, Gg, Gll^Fdw, Gg, Gll^Fdw, Gd^Vhr, Gg, Gg, Gll^Fdw, Gll^Fdw, Gll^Fdw, Gll^Fdw, Gg^Efm, Gg^Efm, Gg^Efm, Gg, Re, Gg^Efm, Gg^Efm, Ww, Ww, Gg, Gg, Gg, Gg^Efm, Gg^Efm, Gg^Efm, Gg^Efm, Gg, Gg^Efm, Gg, Gg, Gg, Gg, Gs^Vh, Gg, Gg, Gg
Gs^Fds, Gs^Fds, Gs^Fms, Gs^Fms, Gg, Gs^Fms, Gs^Fms, Gll^Fdw, Gs^Fms, Gs^Fms, Gs^Fms, Gs^Fds, Gs^Fds, Gs^Fds, Gg, Gg, Gll^Fdw, Gg, Gg, Gg, Gg, Gg, Gg, Re^Vct, Gs^Ecf, Gll^Fdw, Gg, Gg, Gg, Re, Ww^Bw\, Wwr, Gs^Fms, Gg, Gs^Fds, Gs^Fds, Gs^Fds, Gs^Fds, Gs^Fds, Gg^Efm, Gg, Gg, Gs^Fds, Gg^Efm, Gs^Fds, Gg, Gg, Gg, Gg, Gg, Gs^Fds
Gs^Fms, Gs^Fms, Gs^Fms, Gg^Ve, Gs^Fms, Gg, Gs^Fms, Gs^Fms, Gs^Fms, Gs^Fms, Gs^Fms, Gs^Fms, Gs^Fms, Gs^Fds, Gg, Gs^Fds, Gs^Fds, Gll^Fdw, Gll^Fdw, Gll^Fdw, Gg, Gll^Fdw, Gs^Fms, Gll^Fdw, Gll^Fdw, Gll^Fdw, Ww, Ww, Ww, Wwr, Gs^Fms, Rrc, Gs^Fms, Gs^Fds, Gs^Fds, Gs^Fds, Gs^Fds, Gs^Fds, Gs^Fms, Gs^Fds, Gg, Gs^Fds, Gs^Fds, Gs^Fds, Gs^Fds, Gs^Fds, Gs^Fds, Gs^Fds, Gg, Gs^Fds, Gs^Fds
Gs^Fms, Gs^Fms, Gs^Ecf, Gs^Fms, Gs^Fms, Gg, Gs^Fms, Gs^Fms, Gs^Fms, Gs^Fms, Gs^Fms, Gs^Fms, Gs^Fms, Gs^Fds, Gg, Gs^Fds, Gs^Fds, Gs^Fms, Ww, Gs^Fms, Wwr, Gs^Fms, Ww, Ww, Ww, Ww, Ww, Gs^Fds, Gs^Fms, Gs^Fms, Gs^Fms, Rrc, Gs^Fms, Gs^Fds, Gs^Fds, Gs^Fds, Gs^Fds, Gs^Fms, Gs^Fms, Gs^Fms, Gg, Gs^Fms, Gs^Fms, Gs^Fds, Gs^Fds, Gs^Fds, Gs^Fds, Gs^Fds, Gg, Gs^Fds, Gs^Fds
Gs^Fms, Gs^Fms, Ww, Gs^Fms, Ww, Gg, Ww, Gs^Fms, Ww, Ww, Ww, Gs^Ecf, Ww, Wwr, Wwr, Ww, Ww, Ww, Ww, Ww, Wwr, Wwr, Ww, Ww, Ww, Ww, Ww, Gs^Fds, Gs^Fds, Gs^Fms, Gs^Fms, Rrc, Gs^Fms, Gs^Fds, Gs^Fds, Gs^Fds, Gs^Fds, Gs^Fds, Gs^Fds, Gg, Gg^Ve, Gg^Fet, Gs^Fms, Gs^Fms, Gs^Fms, Gs^Fms, Gs^Fms, Gg, Gg^Ve, Gg, Gs^Fds
Ww, Ww, Ww, Ww, Ww, Wwr, Ww, Ww, Ww, Ww, Ww, Ww, Ww, Wwr, Gg, Ww, Gs^Fms, Gs^Fms, Gs^Fms, Gs^Fms, Gg, Gg, Gs^Fms, Gs^Fms, Gs^Fms, Ww, Wwr, Ww, Wwr, Gs^Fms, Gg, Rrc, Rrc, Gs^Fms, Gs^Fms, Gs^Fds, Gs^Fds, Gs^Fds, Gs^Fds, Gg, Gg, Gg, Gs^Fms, Gs^Fms, Gs^Fms, Gs^Fms, Gs^Fms, Gg, Gg, Gg, Gs^Fds
Ww, Ww, Ww, Ww, Ww, Wwr, Ww, Ww, Gs^Fms, Ww, Gs^Fms, Gs^Fms, Gs^Fms, Gg, Gg, Gs^Fms, Gs^Fms, Gs^Fms, Gs^Fms, Gs^Fms, Gg, Gg, Gs^Fms, Gs^Fms, Gg, Gg, Gg, Wwr, Wwr, Wwr, Wwr, Gg, Gs^Fms, Rrc, Gs^Fms, Gs^Fds, Gs^Fds, Gs^Fds, Gs^Fds, Gs^Fds, Gs^Fms, Gg, Gs^Fms, Gs^Fms, Gs^Fms, Gs^Fms, Gs^Fms, Gs^Fms, Gg, Gg, Gs^Fds
Ww, Ww, Ww, Ww, Gs^Fms, Wwr, Gg, Gs^Fms, Gs^Fms, Gs^Fms, Gs^Fms, Gs^Fms, Gs^Fms, Gs^Fms, Gs^Fms, Gg, Gg, Gs^Fds, Gs^Fds, Gs^Fds, Gs^Fms, Gg, Gg, Gg^Ve, Gg, Gg, Gg, Gg, Gg, Wwr, Ww, Ww, Gs^Fds, Rrc, Rrc, Gs^Fms, Gs^Fms, Gs^Fds, Gs^Fds, Gs^Fds, Cvr, Cvr, Gs^Fms, Gs^Fms, Gs^Fms, Gs^Fms, Gs^Fds, Gs^Fms, Gg, Gg, Gs^Fds
Ww, Ww, Gs^Fms, Gs^Fms, Gs^Fms, Gs^Fms, Gg, Gs^Fms, Gs^Fds, Gs^Fms, Gs^Fds, Gs^Fds, Gs^Fds, Gs^Fds, Gs^Fds, Gs^Fms, Gs^Fms, Gg, Gg, Gs^Fds, Gs^Fms, Gg, Gg, Gg, Gs^Fms, Gs^Fms, Gs^Fds, Gs^Fds, Gs^Fms, Gs^Fms, Ww, Ww, Ww, Gs^Fms, Gs^Fms, Rrc, Rrc, Gs^Fms, Gs^Fds, Gs^Fds, Cvr, Kvr, Gg, Gg, Gg, Gs^Fds, Gg, Gs^Fms, Gg, Gs^Fms, Gs^Fms
Gs^Fds, Gs^Fms, Gs^Fds, Gs^Fms, Gs^Fms, Gs^Fms, Gg^Ve, Gg, Gg, Gs^Fms, Gs^Fds, Gs^Fms, Gs^Fds, Gs^Fds, Gs^Fds, Gs^Fds, Gs^Fds, Gs^Fms, Gs^Fms, Gg, Gg, Gg, Gs^Fms, Gs^Fms, Gs^Fds, Gs^Fds, Gs^Fds, Gs^Fds, Gs^Fms, Gs^Fms, Gs^Fms, Ww, Ww, Gs^Fds, Gs^Fds, Gs^Fms, Rrc, Gs^Fms, Gg, Gg, Gs^Fds, Gs^Fds, Gs^Fds, Gg, Gs^Fds, Gg, Gg, Gg, Gg, Gg, Gs^Fms
Gs^Fds, Gs^Fds, Gs^Fds, Gs^Fds, Gs^Fds, Gg, Gg, Gg, Gs^Fms, Gs^Fms, Gs^Fms, Gs^Fms, Gs^Fms, Gs^Fms, Gs^Fds, Gs^Fds, Gs^Fds, Gs^Fds, Gs^Fms, Gg, Gg, Gg, Gg, Gs^Fms, Gs^Fms, Gs^Fds, Gs^Fms, Gs^Fds, Gs^Fds, Gs^Fms, Gs^Fms, Ww, Ww, Ww, Ww, Gs^Fms, Wwr, Rrc, Ww^Bsb\, Wwr, Wwr, Ww, Ww, Ww, Ww, Wwr, Ww, Gg^Ve, Gg, Gs^Fms, Gs^Fms
Gs^Fds, Gs^Fds, Gs^Fds, Gs^Fds, Gs^Fms, Gs^Fms, Gs^Fms, Gg, Gg, Gs^Fms, Gs^Fms, Gs^Fms, Gs^Fms, Gs^Fms, Gs^Fds, Gs^Fds, Gs^Fds, Gs^Fms, Gg, Gg^Fet, Gs^Fds, Gs^Fms, Gs^Fms, Gg, Gg, Gs^Fms, Gs^Fms, Gs^Fms, Gs^Fms, Gs^Fds, Gs^Fms, Gs^Fms, Gs^Fms, Ww, Ww, Ww, Ww, Wwr, Wwr, Ww^Bsb\, Rrc, Ww, Gs^Fms, Ww, Gs^Fds, Wwr, Ww, Ww, Ww, Gs^Fms, Gs^Fms
Gs^Fds, Gs^Fds, Gs^Fds, Gs^Fds, Gs^Fms, Gs^Fds, Gs^Fms, Gs^Fms, Gs^Fms, Gg, Gg, Gs^Fms, Gs^Fms, Gs^Fds, Gs^Fms, Gs^Fds, Gg, Gg, Gs^Fds, Gs^Fds, Gs^Fds, Gs^Fms, Gs^Fms, Gs^Fms, Gs^Fms, Gg, Gg, Gs^Fms, Gg, Gs^Fms, Gs^Fms, Gs^Fms, Gs^Fms, Gs^Fms, Gs^Fms, Ww, Gs^Fms, Gs^Fms, Gs^Fms, Gs^Fms, Gs^Fms, Rrc, Rrc, Gs^Fms, Gs^Fms, Gg, Gs^Fds, Ww, Ww, Ww, Ww
Gs^Fds, Gs^Fds, Gs^Fds, Gs^Fds, Gs^Fds, Gs^Fms, Gs^Fds, Gs^Fms, Gs^Fds, Gs^Fms, Gs^Fms, Gg, Gg, Gg, Gg, Gg, Gs^Fds, Gs^Fds, Gs^Fds, Gs^Fds, Gs^Fds, Gs^Fds, Gs^Fms, Gs^Fms, Gs^Fms, Gs^Fms, Gs^Fms, Gg, Gg, Gg, Gg, Gg, Gg, Gs^Fms, Gg, Gs^Fms, Cvr, Cvr, Cvr, Gs^Fms, Gs^Fms, Gs^Fms, Gs^Fms, Rrc, Gg, Gg, Gs^Fms, Gs^Fds, Gs^Fds, Ww, Ww
Gs^Fds, Gs^Fds, Gs^Fds, Gs^Fds, Gs^Fds, Gs^Fds, Gs^Fds, Gs^Fds, Gs^Fds, Gs^Fds, Gs^Fds, Gs^Fds, Gg^Ve, Gg, Gs^Fds, Gs^Fds, Gs^Fds, Gs^Fds, Gs^Fds, Gs^Fds, Gs^Fds, Gs^Fds, Gs^Fms, Gs^Fms, Gs^Fms, Gs^Fms, Gs^Fms, Gg^Ve, Gs^Fms, Gs^Fms, Gs^Fms, Gs^Fms, Gs^Fms, Gg, Gs^Fms, Gg, Gs^Fds, Kvr, Gg, Gg, Gg, Gs^Fds, Gg, Rrc, Rrc, Gs^Fms, Gs^Fms, Gs^Fms, Gs^Fms, Gs^Fds, Gs^Fds
Gs^Fds, Gs^Fds, Gs^Fds, Gs^Fds, Gs^Fds, Gs^Fds, Gs^Fds, Gs^Fds, Gs^Fds, Gs^Fds, Gs^Fds, Gs^Fds, Gs^Fds, Gg, Gs^Fds, Gs^Fds, Gs^Fds, Gs^Fds, Gs^Fds, Gs^Fds, Gs^Fds, Gs^Fds, Gs^Fms, Gs^Fms, Gs^Fms, Gs^Fms, Gs^Fms, Gs^Fms, Gs^Fms, Gs^Fms, Gs^Fms, Gs^Fms, Gs^Fms, Gs^Fms, Gs^Fds, Gs^Fds, Gs^Fds, Gs^Fds, Gs^Fds, Gs^Fds, Gs^Fds, Gg, Gs^Fds, Gs^Fds, Gs^Fms, Rrc, Rrc, Gs^Fms, Gs^Fms, Gs^Fms, Gs^Fms
Gs^Fds, Gs^Fds, Gs^Fds, Gs^Fds, Gs^Fds, Gs^Fds, Gs^Fds, Gs^Fds, Gs^Fds, Gs^Fds, Gs^Fds, Gs^Fds, Gs^Fds, Gs^Fds, Gs^Fds, Gs^Fds, Gs^Fds, Gs^Fds, Gs^Fds, Gs^Fds, Gs^Fds, Gs^Fds, Gs^Fds, Gs^Fds, Gs^Fds, Gs^Fms, Gs^Fms, Gs^Fms, Gs^Fms, Gs^Fms, Gs^Fms, Gs^Fms, Gs^Fds, Gs^Fds, Gs^Fds, Gs^Fds, Gs^Fds, Gs^Fds, Gs^Fds, Gs^Fds, Gs^Fds, Gs^Fds, Gs^Fds, Gs^Fds, Gs^Fds, Gs^Fms, 1 Gg, 2 Rrc, Rrc, Gs^Fms, Gs^Fms
Gs^Fds, Gs^Fds, Gs^Fds, Gs^Fds, Gs^Fds, Gs^Fds, Gg, Gs^Fds, Gs^Fds, Gs^Fds, Gs^Fds, Gs^Fds, Gs^Fds, Gs^Fds, Gs^Fds, Gs^Fds, Gs^Fds, Gs^Fds, Gs^Fds, Gs^Fds, Gs^Fds, Gs^Fds, Gs^Fds, Gs^Fds, Gs^Fds, Gs^Fds, Gs^Fds, Gs^Fms, Gs^Fds, Gs^Fms, Gs^Fms, Gs^Fms, Gs^Fds, Gs^Fds, Gs^Fds, Gs^Fds, Gs^Fds, Gs^Fds, Gs^Fds, Gs^Fds, Gs^Fds, Gs^Fds, Gs^Fds, Gs^Fds, Gs^Fds, Gs^Fms, Gs^Fds, Gg, Gg, Rrc, Rrc
