Gg, Gs^Fms, Ww, Ww, Ww, Gs^Fms, Gs^Fms, Gs^Fms, Gs^Fds, Gs^Fds, Gs^Fds, Gg, Mm, Mm, Mm, Mm, Mm, Mm, Md, Mm, Mm, Mm, Mm, Mm, Mm, Mm, Mm, Mm, Mm, Mm, Mm, Hh, Gs^Fds, Gs^Fds, Hh, Hh, Hh, Hh, Hh, Hh
Gs^Fds, Gs^Fms, Gs^Fms, Ww, Ww, Gs^Fms, Gs^Fms, Gs^Fms, Gs^Fds, Gs^Fds, Gs^Fds, Gll^Fdw, Gll^Fdw, Hh, Ko, Hh, Hh, Hh, Co, Hh, Hh, Mm, Ko, Mm, Mm, Mm, Mm, Mm, Hh, Gs^Fds, Gs^Fds, Gs^Fds, Gg, Gs^Fds, Gg, Gg, Re, Gg, Re, Re
Gs^Fds, Gs^Fds, Gs^Fms, Ww, Ww, Ww, Ww, Gs^Fms, Gs^Fms, Gs^Fds, Gs^Fds, Gll^Fdw, Gll^Fdw, Re^Vct, Rd, Hh, Co, Co, Ko, Co, Co, Hh, Re^Vct, Mm, Mm, Mm, Mm, Mm, Gs^Fds, Gs^Fds, Gg, Gg, Gg^Es, Gg, Re, Re, Gg, Re, Gs^Fds, Gs^Fds
Gs^Fds, Gg^Fet, Gs^Fds, Gs^Fms, Gs^Fms, Ww, Ww, Gs^Fms, Gs^Fms, Gs^Fds, Gs^Fds, Gll^Fdw, Gll^Fdw, Rd, Rd, Rd, Co, Ko, Urb, Ko, Co, Rd, Hh, Hh, Mm, Mm, Gs^Fms, Gs^Fds, Gg, Gs^Fds, Gg, Gg, Re, Re, Gg, Gg, Gs^Fms, Gs^Fds, Gs^Fds, Gs^Fds
Gs^Fds, Gs^Fds, Gs^Fds, Gs^Fds, Gs^Fms, Gs^Fms, Ww, Ww, Gs^Fms, Gs^Fds, Gs^Fds, Gs^Fds, Gll^Fdw, Gll^Fdw, Rd, Re^Vct, Co, Ko, Ko, Ko, Co, Rd, Rd, Rd, Rd, Rd, Rd, Gg, Gg, Gg, Re, Re, Gg, Gg, Gs^Fds, Gs^Fms, Gs^Fds, Gs^Fds, Gs^Fds, Gs^Fds
Gs^Fds, Gs^Fds, Gg^Ve, Gs^Fds, Gs^Fms, Gs^Fms, Ww, Ww, Gs^Fms, Gs^Fms, Gs^Fds, Gs^Fds, Gll^Fdw, Ko, Rd, Rd, Rd, Co, Co, Co, Rd, Rd, Rd, Ko, Rd, Re^Vct, Rd, Gg, Gg, Gg, Re, Gg, Gg, Gg, Gs^Fds, Gs^Fms, Gs^Fds, Gs^Fds, Gs^Fds, Gs^Fds
Gg, Gs^Fds, Gs^Fds, Gs^Fds, Gs^Fms, Gs^Fms, Ww, Ww, Ww, Gs^Fms, Gs^Fms, Gs^Fds, Gll^Fdw, Gll^Fdw, Gll^Fdw, Re^Vct, Rd, Rd, Rd, Rd, Rd, Re^Vct, Rd, Rd, Rd, Rd^Ecf, Rd, Rd, Re, Re, Gg, Gg, Gg, Gg, Gs^Fds, Gs^Fms, Gs^Fds, Gs^Fds, Gs^Fds, Gs^Fds
Gs^Fds, Gs^Fds, Gs^Fds, Gs^Fds, Gs^Fds, Gs^Fms, Gs^Fms, Ww, Ww, Gs^Fms, Gs^Fms, Gs^Fms, Gs^Fms, Gll^Fdw, Gll^Fdw, Gll^Fdw, Rd, Rd, Ko, Rd, Re^Vct, Rd, Rd, Re^Vct, Rd, Rd, Re, Re, Gg, Gg, Gg, Gg^Edb, Rp^Vhcr, Gll^Fdw, Gll^Fdw, Gs^Fds, Gs^Fds, Gs^Fds, Gs^Fds, Gs^Fds
Gs^Fds, Gs^Fds, Gs^Fds, Gs^Fds, Gs^Fds, Gs^Fms, Gs^Fms, Ww, Ww^Ewl, Ww, Gs^Fms, Gs^Fms, Gs^Fds, Gs^Fms, Gll^Fdw, Gll^Fdw, Gll^Fdw, Rd, Rd, Rd, Rd, Rd, Rd, Rd, Rd, Re, Gg, Gg, Gg, Gg, Gg^Edb, Gg^Edb, Gg^Edb, Gll^Fdw, Gll^Fdw, Gs^Fds, Gs^Fds, Gs^Fds, Gs^Fds, Gs^Fds
Gs^Fds, Gs^Fds, Gs^Fds, Gs^Fds, Gs^Fds, Gs^Fds, Gs^Fms, Ww, Ww^Ewl, Ww, Gs^Fms, Gs^Fms, Gs^Fms, Gs^Fds, Gs^Fms, Gs^Fms, Gll^Fdw, Gll^Fdw, Rd^Ecf, Re^Vct, Rd, Rd, Rd, Rd, Re, Re, Gll^Fdw, Rp^Vhcr, Gg^Edb, Gg^Edb, Gg^Edb, Gg^Edb, Gll^Fdw, Gll^Fdw, Gs^Fds, Gs^Fds, Gs^Fds, Gs^Fds, Gs^Fds, Gs^Fds
Gs^Fds, Gs^Fds, Gs^Fds, Gg^Ve, Gs^Fms, Gs^Fds, Gs^Fms, Gs^Fms, Ww, Ww, Ww, Gs^Fms, Gs^Fms, Gs^Fms, Gs^Fms, Gs^Fms, Gs^Fds, Gll^Fdw, Gll^Fdw, Gll^Fdw, Gll^Fdw, Rd, Re, Re, Gll^Fdw, Gll^Fdw, Gll^Fdw, Gll^Fdw, Gg, Gg^Edt, Rp^Vhcr, Gg, Gll^Fdw, Gll^Fdw, Gs^Fds, Gs^Fms, Gs^Fds, Gs^Fds, Gs^Fds, Gs^Fds
Gs^Fds, Gs^Fds, Gs^Fds, Gs^Fms, Gs^Fms, Gs^Fds, Gs^Fds, Gs^Fms, Gs^Fms, Ww, Ww, Ww, Ww, Gs^Fms, Gs^Fms, Gs^Fms, Gs^Fds, Gs^Fds, Gll^Fdw, Gll^Fdw, Re, Re, Gll^Fdw, Gll^Fdw, Gs^Fms, Gs^Fms, Gll^Fdw, Gll^Fdw, Gg, Gg^Edt, Gg^Es, Gg^Edb, Gg, Gll^Fdw, Gll^Fdw, Gs^Fms, Gs^Fms, Gs^Fds, Gs^Fds, Gs^Fds
Gs^Fds, Gs^Fds, Gs^Fds, Gs^Fms, Gs^Fms, Gg^Fet, Gs^Fds, Gs^Fms, Gg^Ve, Gs^Fms, Gs^Fms, Ww, Ww, Ww, Ww, Gs^Fms, Gs^Fms, Gs^Fds, Re, Re, Gll^Fdw, Gll^Fdw, Gll^Fdw, Gs^Fds, Gs^Fms, Gs^Fds, Gll^Fdw, Gg, Gll^Fdw, Gg, Cer, Cer, Cer, Gll^Fdw, Gll^Fdw, Gs^Fds, Gs^Fms, Gs^Fds, Gs^Fds, Gs^Fds
Gs^Fds, Gs^Fds, Gs^Fms, Gs^Fms, Gs^Fms, Gs^Fms, Gs^Fms, Gs^Fds, Gs^Fds, Gs^Fms, Gll^Fdw, Gs^Fms, Gs^Fms, Ww, Ww, Ww, Ww, Gs^Fms, Re, Gs^Fms, Gs^Fms, Gll^Fdw, Gs^Fds, Gs^Fms, Gs^Fms, Gs^Fds, Gs^Fms, Gll^Fdw, Gll^Fdw, Gll^Fdw, Cer, Ker, Cer, Gll^Fdw, Gll^Fdw, Gs^Fms, Gs^Fms, Gs^Fds, Gs^Fms, Gs^Fms
Gs^Fds, Gs^Fds, Gs^Fds, Gs^Fms, Gg^Ve, Gs^Fds, Gll^Fdw, Gll^Fdw, Gll^Fdw, Gll^Fdw, Cer, Gll^Fdw, Gll^Fdw, Gs^Fms, Gs^Fms, Ww, Ww, Ww, Ww, Ww^Ewl, Ww^Ewf, Gs^Fms, Gs^Fms, Gs^Fms, Gs^Fms, Gs^Fms, Gs^Fms, Gs^Fms, Gs^Fms, Gll^Fdw, Gll^Fdw, Cer, Gll^Fdw, Gll^Fdw, Gll^Fdw, Gs^Fms, Gs^Fms, Gs^Fms, Ww^Ewl, Gs^Fms
Gg, Gs^Fds, Gs^Fds, Gs^Fds, Gs^Fds, Gs^Fds, Gll^Fdw, Gll^Fdw, Gll^Fdw, Cer, Ker, Cer, Gll^Fdw, Gs^Fds, Gs^Fds, Gs^Fms, Re, Ww, Gs^Fds, Ww^Ewl, Ww, Ww^Ewl, Ww, Gs^Fms, Gs^Fms, Gs^Fms, Gs^Fms, Gs^Fms, Gs^Fms, Gll^Fdw, Gs^Fms, Gll^Fdw, Ww, Gs^Fms, Ww, Ww, Ww, Ww^Ewl, Wot, Ww
Re, Gg^Efm, Re, Gs^Fds, Gs^Fds, Gs^Fds, Gs^Fds, Gll^Fdw, Gll^Fdw, Cer, Cer, Cer, Gll^Fdw, Gs^Fds, Gs^Fds, Re, Gs^Fds, Gs^Fds, Gs^Fds, Gs^Fds, Ww, Ww, Ww, Ww, Ww^Ewl, Ww^Ewf, Ww^Ewl, Ww^Ewl, Ww, Ww, Ww, Ww, Ww, Ww, Wot, Wot, Wot, Wot, Wot, Wot
Gg^Efm, Re, Gg^Efm, Re, Re^Efm, Re, Re, Gg^Efm, Re, Gll^Fdw, Gg^Es, Gll^Fdw, Gll^Fdw, Gll^Fdw, Gs^Fds, Re, Gs^Fds, Gs^Fds, Ww, Ww, Ww, Ww, Wot, Ww, Wot, Ww, Wot, Wot, Wot, Wot, Wot, Wot, Wot, Wot, Wot, Wot, Wot, Wot, Wot, Wot
Gs^Fds, Gs^Fds, Gs^Fds, Gg^Efm, Gs^Fds, Gg^Efm, Gg^Efm, Re, Gg^Efm, Re, Re, Re, Re, Re, Re, Re, Ww, Ww, Wot, Wot, Wot, Wot, Wot, Wot, Wot, Wot, Wot, Wot, Wot, Wot, Wot, Wot, Wot, Wot, Wot, Wot, Wot, Wot, Wot, Wot
Gg, Gs^Fds, Gs^Fms, Gs^Fms, Gs^Fms, Gs^Fds, Gs^Fds, Gs^Fds, Gs^Fds, Gs^Fds, Gs^Fds, Gg^Efm, Gs^Fds, Gs^Fds, Ww, Ww^Bw\, Wot^Bw\, Wot, Wot, Wot, Wot, Wot, Ww, Ww, Gs^Fms, Ww, Ww, Ww, Ww, Ww, Ww, Ww, Ww, Wot, Ww, Wot, Ww, Wot, Ww, Wot
Ww, Gs^Fds, Ww, Gs^Fds, Ww, Gs^Fds, Ww, Gs^Fds, Ww, Gs^Fds, Ww, Gs^Fds, Ww^Ewf, Ww^Ewl, Wot, Wot, Wot^Bw/, Gg, Wot, Wot, Ww^Ewf, Ww^Ewl, Gs^Fms, Gs^Fms, Gs^Fms, Gs^Fms, Gs^Fms, Gs^Fms, Gs^Fms, Gs^Fms, Gs^Fms, Gs^Fms, Ss, Ss, Ss, Ww^Ewl, Ss, Ww, Ww, Ww
Wot, Ww, Wot, Ww, Wot, Ww^Bw|r, Wot, Ww, Wot, Ww, Wot, Ww^Ewl, Wot, Wot, Wot, Gg, Wot^Bw\, Wot, Ww, Ww, Gs^Fms, Gs^Fms, Gs^Fms, Gs^Fms, Gs^Fds, Gs^Fms, Gs^Fds, Gs^Fms, Gs^Fds, Gs^Fms, Gs^Fds, Ss, Ss, Ss, Rp^Vhcr, Ss, Ss, Ss, Ss, Ss
Wot, Wot, Wot, Wot, Wot, Wot^Bw|r, Wot, Wot, Wot, Wot, Wot, Wot, Wot, Wot, Wot, Wot, Ww, Ww^Bw\, Re, Gs^Fms, Gs^Fms, Gs^Fms, Gs^Fds, Gs^Fds, Gs^Fds, Gs^Fds, Gs^Fds, Gs^Fds, Gs^Fds, Gs^Fds, Gs^Fds, Ss, Gs^Dr, Ss, Chs, Rrc, Ss, Ss, Ss, Ss
Ww, Wot, Ww^Ewl, Ww^Ewl, Ww^Ewl, Ww^Bw|r, Ww, Ww, Ww, Ww, Wot, Wot, Wot, Wot, Ww, Ww, Gs^Fms, Gs^Fms, Gll^Fdw, Re, Re, Gs^Fds, Gs^Fds, Gg, Gs^Fds, Gs^Fds, Gg, Gs^Fds, Gg, Gg, Rp^Vhcr, Rrc^Edb, Rrc^Edb, Rrc^Edb, Rrc, Rrc^Edb, Ss, Ss, Rp^Vhcr, Ss
Gs^Fms, Ww, Gs^Fms, Gs^Fms, Gs^Fms, Gs^Fms, Gs^Fds, Gs^Fms, Gs^Fds, Gs^Fds, Gs^Fds, Wot, Wot, Wot, Ww, Gs^Fms, Gll^Fdw, Gll^Fdw, Cer, Gll^Fdw, Gs^Fds, Re, Re, Gs^Fds, Gs^Fds, Gs^Fds, Gg, Gg, Gg^Efm, Gg^Efm, Rrc^Edb, Chr^Edb, Rrc, Rrc^Edb, Ch, Rrc^Edb, Rrc, Chs, Rrc, Ss
Gs^Fds, Gs^Fds, Gs^Fms, Gg^Fet, Gs^Fms, Gs^Fds, Gs^Fms, Gg^Fet, Mm, Gs^Fds, Gs^Fds, Wot, Ww^Ewf, Ww, Gs^Fms, Gs^Fms, Gll^Fdw, Ker, Cer, Gll^Fdw, Gs^Fds, Gg, Re, Gg, Gg, Gs^Fds, Gg^Efm, Gg^Dr, Gg^Efm, Gg^Efm, Gg^Dr, Rrc, Rrc, Chr^Edb, Khr^Edb, Ch, Rrc, Rrc, Gg^Dr, Gg
Gs^Fds, Gs^Fds, Gs^Fds, Gs^Fms, Gs^Fms, Gs^Fms, Gs^Fms, Gs^Fds, Mm, Mm, Mm, Wot, Ww^Ewl, Ww^Ewl, Gs^Fms, Gs^Fms, Gll^Fdw, Cer, Gll^Fdw, Gll^Fdw, Gg, Gg, Gg^Es, Re, Re, Gg, Gg, Gg^Efm, Gg^Efm, Gg^Efm, Rrc, Rrc, Rrc^Edb, Chr^Edb, Chr^Edb, Chr, Rrc, Rrc, Rrc, Gg
Kvr, Kvr, Kvr, Gs^Fms, Gs^Fms, Gs^Fms, Mm, Mm, Mm, Mm, Wot, Wot, Ww, Gs^Fms, Gs^Fms, Gs^Fms, Gs^Fds, Gll^Fdw, Rb^Gvs, Gg, Gg, Gg^Efm, Gg^Efm, Gg, Gg^Edb, Re, Re, Gg, Gg, Gg^Efm, Rp^Vhcr, Chr^Edb, Rrc^Edb, Rrc^Edb, Rrc^Edb, Rrc^Edb, Rrc^Edb, Chr, Rp^Vhcr, Gg
Kvr, Gs^Fms, Kvr, Gs^Fms, Md, Mm, Mm, Mm, Gs^Fds, Gs^Fds, Wot, Ww, Gs^Fms, Gs^Fms, Gs^Fds, Gs^Fms, Rb^Gvs, Rb^Gvs, Rb^Gvs, Rb^Gvs, Gg^Efm, Gg^Efm, Gg, Gg^Edb, Gg^Edb, Gg, Re, Gg, Gg, Gg, Gg^Efm, Rrc, Gg, Rrc^Edb, Chr, Rrc^Edb, Gg^Efm, Rrc, Gg, Gg
Gs^Fds, Kvr, Md, Md, Md, Md, Md, Gs^Fds, Wot, Wot, Ww, Ww, Gs^Fms, Gs^Fms, Gs^Fds, Gs^Fms, Gs^Fms, Rb^Gvs, Gg, Gg, Rb^Gvs, Rb^Gvs, Rb^Gvs, Gg^Edb, Gg, Gg, Gg^Edb, Re, Re, Gg, Gg, Gg^Efm, Gg, Rrc^Edb, Rp^Vhcr, Rrc, Gg^Efm, Gg^Dr, Gg, Gg
Md, Md, Md, Md, Md, Md, Wot, Wot, Ww, Ww, Gs^Fms, Gs^Fms, Gs^Fms, Gs^Fms, Gs^Dr, Gs^Fds, Gs^Fds, Gs^Fds, Gs^Fds, Rb^Gvs, Rb^Gvs, Rb^Gvs, Gg^Efm, Gg, Rb^Gvs, Gg, Gg^Edb, Gg^Edb, Gg, Re, Re, Gg, Gg, Gg^Es, Gg^Efm, Gg^Efm, Gg^Efm, Gg, Gg, Gg
Md, Md, Wot, Md, Wot, Wot, Ww, Ww, Gs^Fms, Gs^Fms, Gs^Fms, Gs^Fms, Gs^Fds, Gs^Fms, Gs^Fms, Gs^Fds, Gs^Fds, Gs^Fds, Gs^Fds, Rb^Gvs, Gg, Gg^Efm, Rb^Gvs, Rb^Gvs, Rb^Gvs, Rb^Gvs, Gg^Efm, Gg^Efm, Gg^Efm, Gg, Gg, Re, Gg, Gg, Gg^Efm, Gg^Efm, Gg, Gg, Gg, Gs^Fds
Wot, Wot, Ww, Wot, Ww, Ww, Gs^Fms, Gs^Fms, Gs^Fms, Gs^Fms, Gs^Fds, Gs^Fms, Gs^Fms, Gs^Fms, Gs^Fms, Gs^Fms, Gs^Fds, Gs^Fds, Gs^Fds, Gs^Fds, Rb^Gvs, Rb^Gvs, Rb^Gvs, Rb^Gvs, Gg, Gg, Rb^Gvs, Rb^Gvs, Rb^Gvs, Gg, Gg, Re, Gg, Gg^Es, Gg, Gg, Gg, Gg, Gs^Fds, Gs^Fds
Ww, Ww, Gs^Fms, Ww, Gs^Fms, Gs^Fds, Gs^Fms, Gs^Fds, Gs^Fds, Gs^Fds, Gs^Fds, Gg^Fet, Gs^Fds, Gs^Fms, Gs^Dr, Gs^Fds, Cvr, Cvr, Cvr, Gs^Fds, Gs^Fds, Rb^Gvs, Gs^Fds, Gg, Gs^Fds, Rb^Gvs, Gs^Fds, Rb^Gvs, Gg, Gg, Gg, Re, Gg, Gg, Gs^Fds, Gs^Fds, Gs^Fms, Gs^Fds, Gs^Fms, Gs^Fms
Gs^Fms, Gs^Fms, Gs^Fms, Gs^Fms, Gs^Fms, Gs^Fms, Gg^Ve, Gs^Fds, Gs^Fms, Gs^Fds, Gs^Fms, Gs^Fds, Gs^Fms, Gs^Fds, Gs^Fms, Gs^Fds, Cvr, Cvr^Dr, Cvr^Dr, Cvr, Gs^Fds, Gs^Fds, Gs^Fms, Gs^Fms, Gs^Dr, Gs^Fds, Gs^Fds, Gs^Fds, Gs^Fds, Gs^Fds, Gs^Fds, Re, Gs^Fds, Gs^Fds, Gs^Fds, Gs^Fds, Gs^Fms, Gs^Fds, Gs^Dr, Gs^Fds
Gs^Fms, Gs^Fms, Gs^Fms, Gs^Fms, Gs^Fms, Gs^Fms, Gs^Fms, Gs^Fms, Gs^Fms, Gs^Fms, Gs^Fms, Gs^Fms, Gs^Fms, Gs^Fms, Gs^Fms, Gs^Fms, Gs^Fms, Cvr, Cvr, Cvr, Gs^Fms, Gs^Fms, Gs^Fms, Gs^Fms, Gs^Fms, Gs^Fms, Gs^Fms, Gs^Fds, Chr, Chr, Gs^Fds, Re, Gs^Fds, Chr, Chr, Gs^Fms, Gs^Fms, Gs^Fms, Hhd, Hhd
Hhd, Gs^Fms, Hhd, Gs^Fms, Hhd, Gs^Fms, Hhd, Gs^Fms, Hhd, Hhd, Hhd, Hhd, Hhd, Gs^Fms, Gs^Fms, Gs^Fms, Gs^Fms, Gs^Fms, Gs^Fms, Gs^Dr, Gs^Fms, Gs^Fms, Gs^Fms, Gs^Fms, Gs^Fms, Gs^Fms, Gs^Fms, Gs^Fms, Gs^Fms, Khr, Gs^Fds, Re, Gs^Fds, Khr, Gs^Fms, Gs^Fms, Hhd, Gs^Fms, Hhd, Hhd
Md, Hhd, Hhd, Hhd, Md, Hhd, Md, Hhd, Md, Hhd, Md, Hhd, Md, Hhd, Hhd, Hhd, Hhd, Gs^Fms, Hhd, Hhd, Hhd, Hhd, Hhd, Hhd, Hhd, Hhd, Hhd, Hhd, Hhd, Hhd, 1 Hhd^Edb, Rb, 2 Hhd, Hhd, Hhd, Hhd, Hhd, Hhd, Md, Md
Md, Md, Md, Md, Md, Md, Md, Md, Md, Md, Md, Md, Md, Md, Md, Hhd, Md, Md, Md, Hhd, Md, Hhd, Md, Hhd, Md, Hhd, Md, Hhd, Md, Md, Md, Rb, Md, Md, Md, Hhd, Md, Md, Md, Md
Md, Md, Md, Md, Md, Md, Md, Md, Md, Md, Md, Md, Md, Md, Md, Md, Md, Md, Md, Md, Md, Md, Md, Md, Md, Md, Md, Md, Md, Md, Md, Rb, Md, Md, Md, Md, Md, Md, Md, Md
