Mm, Mm, Mm, Mm, Hh, Mm, Re, Gg, Gg, Gg, Hh, Hh, Mm, Mm, Mm, Mm, Mm, Mm, Mm, Mm, Mm, Mm, Mm, Mm, Hh, Hh, Hh, Hh, Ww, Ww, Ww, Ww, Ww, Gg, Ww, Hh, Ww, Hh, Hh, Hh, Hh, Md, Md, Md, Md, Md, Md, Md, Md, Md, Md, Md, Md, Md, Md, Md
Mm, Mm, Mm, Mm, Mm, Hh, Hh, Re, Re, Gg, Gg, Hh, Hh, Mm, Mm, Mm, Mm, Mm, Mm, Mm, Mm, Mm, Mm, Mm, Mm, Hh, Hh, Ww, Ww, Ww, Ww, Ww, Ww, Ww, Ww, Ww, Gg, Ww, Ww, Hh, Hh, Hh, Hh, Md, Md, Md, Md, Md, Md, Md, Md, Md, Md, Md, Md, Md
Mm, Mm, Mm, Mm, Mm, Mm, Mm, Hh, Hh, Re, Re, Gg, Gg, Hh, Hh, Mm, Mm, Mm, Mm, Mm, Mm, Mm, Mm, Mm, Mm, Hh, Ww, Ww, Gs^Fms, Ww, Ww, Ww, Gs^Fms, Ww, Ww, Gg, Gg, Gg, Gg, Ww, Ww, Hh, Gs^Fms, Hh, Hh, Md, Md^Ecf, Md, Re^Vct, Md, Md^Ecf, Md, Md, Md, Md, Md
Mm, Mm, Mm, Mm, Mm, Mm, Mm, Mm, Hh, Gg, Gg, Re, Re, Gg, Gg, Hh, Hh, Mm, Mm, Mm, Mm, Mm, Mm, Mm, Hh, Hh, Ww, Gg, Gg, Gs^Fms, Gs^Fms, Gs^Fms, Gs^Fms, Ww, Ww, Gg, Gg, Gs^Vh, Gs^Fms, Gs^Fms, Gs^Fms, Ww, Gs^Fms, Gs^Fms, Gs^Fms, Hh, Re^Vct, Hh, Rd, Rd, Rd, Hh, Re^Vct, Md, Hh, Hh
Mm, Mm, Mm, Mm, Mm, Mm, Mm, Mm, Hh, Hh, Hh, Gg, Gg, Re, Re, Gg, Hh, Hh, Hh, Hh^Vhh, Hh, Mm, Hh, Hh, Hh, Hh, Ww, Gg^Efm, Gg^Efm, Gs^Fms, Gs^Fms, Gs^Fms, Gs^Fms, Ww, Ww, Ww, Gg, Gg^Es, Gg, Gs^Fms, Gs^Fms, Gs^Fms, Gs^Fms, Gs^Fms, Re^Vct, Gs^Fms, Rd, Rd, Ce, Ce, Ce, Rd, Rd, Hh, Gg^Ecf, Gg
Hh, Mm, Hh, Hh, Hh, Mm, Hh, Mm, Hh, Hh, Hh, Gg, Gg, Gg, Re, Gg, Gg, Hh, Gg, Hh, Hh, Hh, Gg, Gg, Gg, Ww, Gg^Efm, Gg^Efm, Gg^Efm, Gg, Gg, Gs^Fms, Gs^Fms, Gs^Fms, Ww, Ww, Gg^Efm, Gg, Gg, Gs^Fms, Gs^Fms, Gs^Fms, Gs^Fms, Gs^Fms, Gs^Fms, Rd, Ce, Ce, Ce, Ke, Ce, Rd, Re^Vct, Rd, Re, Re
Hh, Hh, Hh, Hh, Gs^Fms, Hh, Hh, Hh, Hh, Hh, Gg, Gg, Gg^Efm, Gg, Gg, Re, Re, Gg, Gg, Gg, Gg, Gg, Gg, Gg, Gg, Gg^Efm, Gg^Efm, Gg^Efm, Gg^Efm, Gg^Efm, Gg, Gg, Gg, Gs^Fms, Ww, Ww, Gg^Efm, Gg^Efm, Gg^Efm, Gg, Gg, Gs^Fms, Gg, Gg^Ecf, Gs^Fms, Rd, Ce, Ce, Ce, Ce, Ce, Rd, Rd, Re, Hh, Hh
Gg, Gg, Gs^Fms, Hh, Gs^Fms, Gs^Fms, Gg, Gg, Gg, Gg, Gg^Efm, Gg^Efm, Gg^Efm, Gg^Efm, Gg, Gg, Gg, Re, Re, Gg, Gg, Gg, Gg, Gg, Gg, Gg, Gg^Efm, Gg^Efm, Gg^Efm, Gg^Efm, Gg, Gg, Gg, Gg, Ww, Ww, Gg^Efm, Gg^Efm, Gg^Efm, Gg^Efm, Gg^Efm, Gg, Gg^Es, Gg, Re^Vct, Rd, Rd, Ce, Ce, Ce, Rd, Rd, Re, Re, Hh, Md
Gg, Gg, Gg, Gs^Fms, Gs^Fms, Gs^Fms, Gs^Fms, Gg, Gg, Gg^Efm, Gg, Gg^Efm, Gg, Gg^Efm, Gg, Gg, Gg^Es, Gg, Gg, Re, Re, Gg, Gg, Gg, Gg, Gg^Es, Gg^Efm, Gg^Efm, Gg^Efm, Gg^Efm, Gg^Efm, Gg, Gs^Fms, Gs^Vh, Ww, Ww, Gg^Efm, Gg^Efm, Gg^Efm, Gg^Efm, Gg^Efm, Gg, Gg, Gg, Gg, Gg, Gg^Ecf, Rd, Rd, Rd, Re, Re, Hh, Hh, Md, Md
Gs^Fms, Gs^Fms, Gs^Fms, Gs^Fms, Gs^Fms, Gs^Fms, Gs^Fms, Gg, Gg, Gg, Gs^Fms, Gg, Gs^Fms, Gs^Fms, Gs^Fms, Gs^Fms, Gs^Fms, Gg, Gg, Gg, Re, Gg, Gg, Gg, Gg, Gg, Gg, Gg^Efm, Gg^Efm, Gg^Efm, Gg^Efm, Gs^Fms, Gs^Fms, Gs^Fms, Gs^Fms, Ww, Ww, Gg^Efm, Gg^Efm, Gg^Efm, Gg^Efm, Gg^Efm, Gg, Gg, Gg, Gg, Gg, Gg, Re, Re, Hh, Hh, Md, Md, Md, Md
Gg, Gs^Fms, Gs^Fms, Gs^Fms, Gs^Fms, Gs^Fms, Gg, Gg, Gg, Gg, Gs^Fms, Gs^Fms, Gs^Fms, Gs^Fms, Gs^Fms, Gs^Fms, Gs^Fms, Gg, Gg, Gg, Gg, Re, Re, Gg, Gg, Gg, Gg, Gg, Gs^Fms, Gg^Efm, Gg^Efm, Gs^Fms, Gs^Fms, Gs^Fms, Gs^Fms, Ww, Ww, Gg^Efm, Gg^Efm, Gg^Efm, Gg^Efm, Gg^Efm, Gg^Efm, Gg, Gg, Gg, Re, Re, Gg, Gg, Gg, Hh, Md, Md, Md, Md
Gg, Gg, Gs^Fms, Gs^Fms, Gs^Fms, Gg, Gg, Gg, Gg, Gg, Gg, Gs^Fms, Gg, Gs^Fms, Gg, Gg, Gs^Fms, Gs^Fms, Gg, Gg, Gg, Gg, Gg, Re, Re, Gg, Gg, Gg, Gs^Fms, Gs^Fms, Gs^Fms, Gs^Fms, Gs^Fms, Gs^Fms, Gs^Fms, Ww, Ww, Gg^Efm, Gg^Efm, Gg^Efm, Gg^Efm, Gg^Efm, Gg^Efm, Gg, Re, Re, Gg, Gg, Gg, Gg, Gg, Hh^Vhh, Hh, Md, Md, Md
Gg, Gs^Fms, Gg, Gs^Fms, Gg, Gg, Gg, Gg, Gg, Gg, Gg, Gg, Gg, Gg, Gg, Gg, Gg, Gs^Fms, Gg, Gg, Gg^Es, Gg, Gg, Gg, Gg, Re, Gg, Gg, Gs^Fms, Gs^Fms, Gs^Fms, Gs^Fms, Gs^Fms, Gs^Fms, Gs^Fms, Ww, Ww, Gg, Ww, Gg^Efm, Ww, Gg^Efm, Gg, Re, Gg, Gg, Gs^Fms, Gg^Es, Gs^Fms, Gg, Gs^Fms, Gs^Fms, Hh, Hh, Hh, Md
Gg, Gg, Gg^Efm, Gg, Gg^Efm, Gg, Gg^Efm, Gs^Vh, Gg, Gg^Es, Gg, Gg, Gg, Gg, Gg, Gg, Gg, Gg, Gs^Fms, Gg, Gg, Gg, Gg, Gg, Gg, Re, Re, Gg, Gg, Gs^Fms, Gs^Fms, Gs^Fms, Gs^Fms, Gs^Fms, Gs^Fms, Ww, Ww, Ww, Ww, Ww, Wwr, Wwr, Ww^Bw/, Re, Gs^Fms, Gs^Fms, Gs^Fms, Gs^Fms, Gs^Fms, Gs^Fms, Gs^Fms, Gs^Fms, Gs^Fds, Hh, Hh, Hh
Gg, Gg, Gg^Efm, Gg^Efm, Gg^Efm, Gg^Efm, Gg^Efm, Gg^Efm, Gg^Efm, Gg, Gg, Gg, Gg, Gg^Es, Gg, Gg, Gs^Fms, Gs^Fms, Gs^Fms, Gs^Fms, Gs^Fms, Gg, Gs^Fms, Gg, Gg, Gg, Gg, Re, Re, Gg^Es, Gg, Gs^Fms, Gs^Fms, Gs^Fms, Ww^Ewl, Ww^Ewf, Ww^Ewl, Gg, Gg, Ww, Re, Ww^Bw/, Wwr, Wwr, Ww, Gs^Fms, Gs^Fms, Gs^Fms, Ww, Gs^Fms, Gs^Fms, Gs^Fms, Gs^Fms, Gs^Fms, Gs^Fms, Gs^Fms
Gg, Gg^Es, Gg, Gg^Efm, Gg^Efm, Gg^Efm, Gg^Efm, Gg^Efm, Gg^Efm, Gg, Gg, Gg, Gg, Gg, Gg, Gg, Gg, Gg, Gs^Fms, Gs^Fms, Gs^Fms, Gs^Fms, Gs^Fms, Gg, Gg, Gg, Gg, Gg, Gg, Re, Re, Gg, Gg, Gg, Ww, Ww^Ewl, Wwr, Gg, Re, Re, Gg, Gg, Gs^Fms, Ww, Ww, Ww, Ww, Ww, Ww, Ww, Ww, Gs^Fms, Gs^Fms, Gs^Fms, Gs^Fms, Gs^Fds
Gg, Gg, Gg, Gg, Gg, Gg, Gg, Gg, Gg, Gg, Gs^Fms, Gg, Gg, Gg, Gg, Gg, Gg, Gg, Gs^Fms, Gs^Fms, Gs^Fms, Gs^Fms, Gg^Efm, Gs^Fms, Gs^Fms, Gg, Gg, Gg, Gs^Fms, Gg, Gg, Re, Re, Gg, Wwr, Wwr, Ww^Bw/, Ww^Bw/, Gg, Gg, Gg, Re^Vct, Gll^Fdw, Gs^Fms, Gs^Fms, Ww, Ww, Ww, Gs^Vh, Ww, Ww, Gs^Fms, Gs^Fds, Gs^Fms, Gs^Fms, Gs^Fds
Gg, Gg, Gg, Gg, Gs^Fms, Gs^Fms, Gs^Fms, Gs^Fms, Gs^Fms, Gs^Fms, Gs^Fms, Gg, Gs^Fms, Gg, Gs^Fms, Gs^Fms, Gs^Fms, Gs^Fms, Gs^Fms, Gs^Fms, Gs^Fms, Gg^Fet, Gg^Ve, Gg^Efm, Gs^Fms, Gs^Fms, Gs^Fms, Gs^Fms, Ce, Gg, Gg, Gg, Gg, Re, Ww^Bw\, Ww^Bw/, Wwr, Wwr, Re^Vct, Gg, Rd, Rd, Rd, Gll^Fdw, Re^Vct, Gs^Fms, Gs^Fms, Gs^Fms, Gs^Fms, Ww, Ww, Gs^Fds, Gs^Fds, Gs^Fds, Gs^Fds, Gs^Fds
Gg, Gg, Gg, Gg, Gg, Gs^Fms, Gs^Fms, Gs^Fms, Gs^Fms, Gs^Fms, Gs^Fms, Gs^Fms, Gs^Fms, Gs^Fms, Gs^Fms, Gs^Fms, Gs^Fms, Gs^Fms, Gs^Fms, Gs^Fms, Gs^Fms, Gg^Efm, Gg^Efm, Gg^Efm, Gs^Fms, Gs^Fms, Gs^Fms, Ce, Ke, Ce, Gg^Es, Gg, Gg, Wwr, Wwr, Wwr, Ww^Ewl, Ww^Ewl, Gg, Rd, Ce, Ke, Ce, Rd, Gll^Fdw, Gs^Fms, Gs^Fms, Gs^Fms, Gs^Fms, Ww, Ww, Gs^Fds, Gs^Fds, Gs^Fds, Gs^Fds, Gs^Fds
Gg, Gg, Gg, Gg, Gs^Fms, Gs^Fms, Gs^Fms, Gs^Fms, Gg^Fet, Gs^Fms, Gg^Efm, Gs^Fms, Gs^Fms, Gs^Fms, Gs^Fms, Gs^Fms, Gs^Fms, Gs^Fms, Gs^Fms, Gs^Fms, Gs^Fms, Gs^Fms, Gs^Fms, Gs^Fms, Gs^Fms, Gs^Fms, Gs^Fms, Ce, Ce, Ce, Gg, Gg, Gg, Wwr, Wwr, Ww^Ewl, Ww^Ewl, Ww^Ewf, Gg, Rd, Ce, Ke, Ce, Rd, Gll^Fdw, Gs^Fms, Gs^Fms, Gs^Fms, Gs^Fms, Gs^Fms, Ww, Ww, Ww, Ww, Ww, Ww
Gg^Efm, Gg^Efm, Gg^Efm, Gg, Gs^Fms, Gs^Fms, Gs^Fms, Gs^Fms, Gs^Fms, Gg^Efm, Gg^Ve, Gg^Efm, Gs^Fms, Gs^Fms, Gs^Fms, Gg^Efm, Gg^Efm, Gg^Efm, Gg^Efm, Gs^Fms, Gs^Fms, Gs^Fms, Gs^Fms, Gs^Fms, Gs^Fms, Gs^Fms, Gg, Gg, Gg, Gg, Gg, Gg, Re, Wwr^Bw/, Wwr^Bw\, Wwr, Wwr, Ww, Re^Vct, Rd, Rd, Ke, Rd, Rd, Re^Vct, Gs^Fms, Gg, Gs^Fms, Gs^Fms, Gs^Fms, Ww, Ww, Ww^Ewf, Ww, Ww^Ewl, Ww
Gg^Efm, Gg^Efm, Gg^Efm, Gg, Gg, Gs^Fms, Gs^Fms, Gs^Fms, Gs^Fms, Gg^Efm, Gg^Efm, Gg^Efm, Gs^Fms, Gs^Fms, Gs^Fms, Gg^Efm, Gg^Efm, Gg^Efm, Gg^Efm, Gs^Fms, Gg^Efm, Gg^Efm, Gg, Gs^Fms, Gs^Vh, Gg, Gg, Gg, Re, Re, Re, Re, Gg, Wwr, Wwr, Wwr^Bw\, Wwr^Bw\, Wwr, Gg, Gg, Gg, Rd, Gg^Efm, Gg, Gg^Efm, Gg^Efm, Gg^Efm, Gs^Fms, Gs^Fms, Ww, Ww, Ww^Ewl, Ww^Ewf, Ww^Ewf, Ww^Ewl, Ww
Gg^Efm, Gg^Efm, Gg^Efm, Gg^Efm, Gg, Gs^Fms, Gs^Fms, Gs^Fms, Gs^Fms, Gs^Fms, Gs^Fms, Gs^Fms, Gs^Fms, Gs^Fms, Gs^Fms, Gs^Fms, Gg^Efm, Gg^Efm, Gg^Efm, Gg^Efm, Gg, Gg, Gg, Gs^Fms, Gg, Gg, Re, Re, Gg, Gg, Gg, Gg, Ww^Ewl, Ww, Ww, Wwr, Wwr, Wwr^Bw\, Re, Gg, Gg, Re^Vct, Gg^Efm, Gg^Efm, Gg^Efm, Gg^Efm, Gs^Fms, Gs^Fms, Gs^Fms, Ww, Ww, Ww, Ww, Ww^Ewl, Ww, Ww
Gg^Efm, Gg^Efm, Gg, Gg, Gg, Gg, Gs^Fms, Gs^Fms, Gs^Fms, Gs^Fms, Gs^Fms, Gs^Fms, Gs^Fms, Gs^Fms, Gs^Fms, Gs^Fms, Gs^Fms, Gg, Gg, Gg^Efm, Gg, Gg, Re, Gg, Re, Re, Gs^Fms, Gs^Fms, Gg, Gg, Ww, Ww^Ewl, Ww^Ewf, Ww^Ewl, Ww, Ww, Ww, Wwr, Gg, Re, Re, Gg, Gg, Gg^Efm, Gg^Efm, Gg^Efm, Gs^Fms, Gs^Fms, Gs^Fms, Gs^Fms, Gs^Fms, Ww, Ww, Ww, Ww, Ww
Gg, Gg^Efm, Gg, Gg^Es, Gg, Gg, Gg, Gg, Gg, Gs^Fms, Gs^Fms, Gs^Fms, Gg, Gs^Fms, Gs^Fms, Gs^Fms, Gg, Gg, Gg, Gg, Re, Re, Gg, Re, Gg, Gs^Fms, Gs^Fms, Gs^Fms, Ww, Ww, Ww, Ww^Ewl, Ww^Ewl, Ww^Ewl, Ww, Ww, Gg, Gs^Fms, Gg, Gg, Gg, Re, Re, Gg, Gg, Gg^Efm, Gg, Gs^Fms, Gs^Fms, Gs^Fms, Gs^Fms, Gs^Fms, Gs^Fms, Gs^Fds, Gs^Efm, Gs^Fds
Gg, Gg^Efm, Gg, Gg, Gg, Gg, Gg, Gg, Gg, Gg, Gg, Gg, Gg, Gg, Gg, Gg, Gg, Gg, Re, Re, Gg, Gg, Gg, Gg, Gg, Gg, Ww, Ww, Ww, Ww, Ww, Ww, Ww, Ww, Gg, Gg, Gg, Gg^Efm, Gg^Efm, Gg^Efm, Gg^Efm, Gg, Gg, Re, Gg, Gg, Gg, Gg, Gg, Gs^Fms, Gs^Fms, Gs^Fms, Gs^Fms, Gs^Fms, Gs^Efm, Gs^Fms
Gg, Gg, Gg, Gg, Gg, Gg, Gg, Gg, Gg, Gg, Gg, Gg, Gg, Gg, Re, Gg, Re, Re, Gg, Gg, Gg, Gg, Gg, Gg, Ww, Ww, Ww, Ww, Gg, Gg^Efm, Gg^Efm, Gg, Gg, Gg, Gg, Gg, Gs^Vh, Gg^Efm, Gg^Efm, Gg^Efm, Gg^Efm, Gg^Efm, Gg, Re, Re, Gg, Gg, Gg, Gg, Gs^Fds, Gs^Fms, Gs^Fms, Gs^Fds, Gs^Efm, Gg^Ve, Gs^Efm
Gg, Gg, Gg, Gg, Gg, Gs^Vh, Gg, Gg, Gg, Gg, Gg, Gg, Re, Re, Gg, Re, Gg, Gg, Ww, Gg, Gg^Efm, Gg, Ww, Ww, Ww, Ww, Gg, Gg, Gg, Gg^Efm, Gg, Gg, Gg, Gg, Gg, Gg, Gg^Efm, Gg^Efm, Gg^Efm, Gg^Efm, Gg^Efm, Gg^Efm, Gg^Efm, Gg, Gg, Re, Re, Gg, Gg, Gs^Fds, Gs^Fds, Gs^Fds, Gs^Fds, Gs^Efm, Gs^Efm, Gs^Efm
Gg, Gg, Gg, Gg, Gg, Gg, Gg, Gg, Re, Re, Re, Re, Gg, Gg, Wwr, Gg^Efm, Ww^Bw\, Wwr, Wwr, Ww, Ww, Ww, Ww, Ww, Gg, Gg, Gg, Gg, Gs^Fms, Gg, Gs^Fms, Gg, Gs^Fms, Gg, Gg, Gg^Efm, Gg^Efm, Gg^Efm, Gg, Gg^Efm, Gg^Efm, Gg^Efm, Gg^Efm, Gg^Efm, Gg, Gg^Es, Re, Gg, Gg, Gg, Gs^Fds, Gs^Fds, Gs^Fds, Gs^Fds, Gs^Fds, Gs^Fds
Gg, Gg, Gg, Gg, Gg, Gg, Re, Re, Gg, Gg, Gg, Gg, Ww, Ww, Ww, Wwr, Wwr, Ww^Bw\, Gg^Efm, Ww, Ww, Ww, Gg, Gg, Gg, Gg, Gs^Fms, Gs^Fms, Gs^Fms, Gs^Fms, Gs^Fms, Gs^Fms, Gs^Fms, Gs^Fms, Gs^Fms, Gg^Efm, Gg, Gg^Efm, Gs^Fms, Gs^Fms, Gs^Fms, Gg^Efm, Gs^Fms, Gg^Efm, Gg, Gg, Gg, Re, Re, Gg, Gg, Ce, Ce, Gs^Fds, Gs^Fds, Gs^Fds
Gg, Gg, Re, Gg, Re, Re, Gg, Gg, Gg, Gg, Ww, Ww, Ww, Ww, Gg, Ww, Gg, Gg^Efm, Gg, Gg, Gg, Gg, Gs^Vh, Gg, Gg, Gs^Fms, Gs^Fms, Gs^Fms, Gs^Fms, Gs^Fms, Gs^Fms, Gs^Fms, Gs^Fms, Gs^Fms, Gg, Gg, Gs^Fms, Gs^Fms, Gs^Fms, Gs^Fms, Gs^Fms, Gs^Fms, Gs^Fms, Gg, Gs^Fds, Gs^Fds, Gg, Ce, Ce, Re, Re, Ce, Ce, Ce, Gs^Fds, Gs^Fds
Re, Re, Gg, Re, Gg, Gg, Ww, Gg, Ww, Ww, Ww, Ww, Gg, Gg, Gs^Fms, Gg, Gs^Fms, Gs^Fms, Gs^Fms, Gg, Gg, Gg, Gg^Es, Gg, Gg, Gs^Fms, Gs^Fms, Gs^Fms, Gs^Fms, Gs^Fms, Gs^Fms, Gs^Fms, Gg, Gg^Efm, Gg^Efm, Gg, Gg, Gs^Fms, Gs^Fms, Gs^Fms, Gg^Fet, Gs^Fms, Gs^Efm, Gs^Fds, Gs^Efm, Gs^Fds, Gs^Fds, Ce, Ce, Ce, Gg, Re, Re, 2 Ke, Gg, Gg
Gg, Gg, Gg, Gg, Ww, Ww, Ww, Ww, Ww, Ww, Gg, Gs^Fms, Gs^Fms, Gs^Fms, Gs^Fms, Gs^Fms, Gs^Fms, Gs^Fms, Gs^Fms, Gs^Fms, Gg, Gg, Gg, Gg, Gs^Fms, Gs^Fms, Gs^Fms, Gs^Fms, Gs^Fms, Gs^Fms, Gg, Gg, Gg^Efm, Gg^Efm, Gg^Efm, Gg^Efm, Gs^Fms, Gs^Fms, Gs^Fms, Gs^Fms, Gs^Fds, Gs^Efm, Gs^Efm, Gs^Efm, Gg^Ve, Gs^Fds, Gs^Fds, Gs^Fds, Gs^Fds, 1 Ke, Gs^Fds, Gg, Gg, Re, Re, Gg
Gg, Gg, Ww, Ww, Ww, Ww, Gg^Efm, Ww, Gg, Gg, Gg, Gs^Fms, Gs^Fms, Gs^Fms, Gs^Fms, Gs^Fms, Gs^Fms, Gs^Fms, Gg, Gg, Gg^Efm, Gg^Efm, Gg^Efm, Gg^Efm, Gg^Efm, Gs^Fms, Gs^Fms, Gs^Fms, Gs^Fms, Gs^Fms, Gg, Gg, Gg^Efm, Gg^Es, Gg^Efm, Gg, Gs^Fds, Gs^Fms, Gs^Fds, Gs^Fds, Gs^Fms, Gs^Fds, Gs^Fds, Gs^Efm, Gs^Fds, Gs^Fds, Gs^Fds, Gs^Fds, Gs^Fds, Gs^Fds, Gs^Fds, Gs^Fds, Gg, Gg, Gg, Re
Gg, Ww, Ww, Ww, Gg^Efm, Gg^Efm, Gg^Efm, Gg^Efm, Gg^Efm, Gg^Efm, Gg, Gg, Gg, Gs^Fms, Gg, Gs^Fms, Gg, Gs^Fms, Gg, Gg, Gg, Gg^Efm, Gg, Gg^Efm, Gs^Fms, Gs^Fms, Gs^Fms, Gs^Fms, Gg, Gg^Efm, Gg, Gg, Gg, Gg^Efm, Gg, Gg, Gg, Gs^Fds, Gg, Gs^Fds, Gs^Fds, Gs^Fds, Gs^Fds, Gs^Fds, Gs^Fds, Gs^Fds, Gg, Gs^Fds, Gs^Fds, Gs^Fds, Gs^Fds, Gs^Fds, Gg, Gg, Gg, Gg
