Ms^Xm, Ms^Xm, Ms^Xm, Ms^Xm, Ms^Xm, Ms^Xm, Ms, Ms^Xm, Re, Mm, Ms, Mm, Ms, Mm, Ms^Xm, Ms^Xm, Ms^Xm, Ms^Xm, Ms^Xm, Ms^Xm, Ms^Xm, Ms^Xm, Ms^Xm, Ms^Xm, Ms^Xm, Ms^Xm, Ms, Ms, Ms, Ms, Ms^Xm, Ms, Ms
Ms^Xm, Ms^Xm, Ms^Xm, Ms^Xm, Ms, Ms, Ms, Ms, Re, Ms, Ms, Ms, Ha^Vhha, Ms, Ms, Ms, Ms, Ms, Ms, Ms, Ha, Ha, Ha, Ms, Ms, Ms, Ms, Ms, Ms, Ms, Ms^Xm, Ms^Xm, Ms^Xm
Ms^Xm, Ms^Xm, Ms, Ms, Ms, Ms, Ms, Ms, Re, Ms, Ha, Ha, Aa^Fpa, Aa^Fpa, Aa^Fpa, Ha, Cha, Kha^Ii, Cha, Cha, Cha, Kha^Ii, Cha, Cha, Cha, Kha^Ii, Cha, Ms, Ha, Ms, Ms, Ms^Xm, Ms
Mm, Ms, Ms, Ms, Mm, Mm, Mm, Mm, Re, Hh, Aa^Fpa, Aa^Fpa, Aa^Fpa, Aa^Fpa, Kha^Ii, Cha, Gg^Es, Rr^Vhc, Gg^Efm, Gg^Efm, Gg^Efm, Rr^Vhc, Gg^Efm, Gg^Efm, Gg^Efm, Rr^Vhc, Gg^Es, Cha, Kha^Ii, Ms, Ms, Ms, Ms
Mm, Mm, Mm, Mm, Mm, Mm, Hh^Vhh, Hh, Re, Aa^Fpa, Gs^Fms, Aa^Fpa, Aa^Fpa, Ha, Ch, Rr^Vhc, Gg^Efm, Gg^Efm, Kh, Kh, Kh, Gg^Efm, Kh, Kh, Kh, Gg^Efm, Gg^Efm, Gg^Fet, Gg^Efm, Cha, Ha, Ms, Ms
Mm, Mm, Mm, Mm, Hh, Hh, Gs, Gs^Fms, Re, Gs^Fms, Gs^Fms, Gs^Fms, Hh, Kh^Ii, Rrc, Gg^Efm, Kh, Kh, Rrc, Rrc, Rrc, Rrc, Rrc, Kh, Rrc, Kh, Kh, Kh, Kh, Cha, Ms^Xm, Ha, Ha
Mm, Mm, Mm, Mm, Gs^Fms, Gs^Fms, Gs, Gs, Gs^Fms, Re, Re, Gs^Fms, Rrc, Rrc, Rrc, Rrc, Kh, Kh, Rrc, Rrc, Rrc, Rrc, Rrc, Rrc, Rrc, Kh, Kh, Kh, Kh, Kha^Ii, Ms^Xm, Ms^Xm, Ms^Xm
Mm, Mm, Gs^Fms, Gs^Fms, Gs^Fms, Gg^Vwm, Gs, Gs^Fms, Gs^Fms, Gs^Fms, Re, Rrc, Gs^Fms, Kh^Ii, Ch, Gg^Efm, Gg^Efm, Kh, Kh, Rrc, Kh, Rrc, Kh, Kh, Kh, Kh, Gg^Efm, Kh, Gg^Es, Ch, Mm, Ms^Xm, Ms^Xm
Ww, Mm, Ww, Gs^Fms, Gs^Fms, Gs^Fms, Gs^Fms, Gs^Fms, Gs^Fms, Gs^Fms, Gs^Fms, Re, Re, Hh, Kh^Ii, Rr^Vhc, Gg^Efm, Gg^Efm, Gg^Efm, Kh, Gg^Efm, Gg^Efm, Gg^Efm, Kh, Gg^Efm, Gg^Efm, Gg^Efm, Gg^Fet, Kh^Ii, Ch, Mm, Ms^Xm, Ms^Xm
Mm, Ww, Gs^Fms, Ww, Ww, Ww, Ww, Gs^Fms, Gs^Fms, Gs^Fms, Gs^Fms, Gs^Fms, Re, Gs^Fms, Mm, Ch, Ch, Gg^Efm, Rr^Vhc, Gg^Efm, Gg^Efm, Gg^Es, Gg^Efm, Gg^Efm, Gg^Efm, Rr^Vhc, Ch, Ch, Mm, Hh, Mm, Ms^Xm, Ms^Xm
Mm, Mm, Hh, Gs^Fms, Gs^Vh, Gs^Fms, Gs^Fms, Ww, Ww, Gs^Fms, Gs^Fms, Gs^Fms, Gs^Fms, Re, Mm, Mm, Mm, Kh^Ii, Ch, Gg^Efm, Ch, Rr^Vhc, Ch, Gg^Efm, Ch, Kh^Ii, Ms^Xm, Mm, Ms^Xm, Mm, Ms^Xm, Ms^Xm, Ms^Xm
Mm, Mm, Mm, Hh, Hh, Gs, Gs, Gs, Gs, Ww, Ww, Gs^Fms, Re, Re, Gs^Fms, Mm, Mm, Mm, Mm, Ch, Mm, Kh^Ii, Mm, Ms^Xm, Ms^Xm, Ms^Xm, Ms^Xm, Ms^Xm, Ms^Xm, Ms^Xm, Mm, Ms^Xm, Mm
Mm, Mm, Mm, Mm, Mm, Hh, Hh, Hh, Hh, Gs, Gs, Wwr, Ww^Bw|, Gs^Fms, Gs^Fms, Mm, Mm, Mm, Mm, Mm, Mm, Mm, Mm, Mm, Mm, Ms^Xm, Mm, Ms^Xm, Mm, Mm, Mm, Mm, Ww
Md^Xm, Mm, Mm, Mm, Mm, Mm, Mm, Mm, Hh, Gs^Fms, Gs^Fms, Gs, Re, Wwr, Ww, Gs^Fms, Gs^Fms, Mm, Hh, Mm, Mm, Mm, Hh^Vhh, Mm, Mm, Mm, Hh, Mm, Mm, Mm, Ww, Ww, Mm
Md^Xm, Md^Xm, Md^Xm, Mm, Mm, Mm, Mm, Mm, Gs^Fms, Gs^Fms, Gs^Fms, Gs^Fms, Re, Gs^Fms, Gs^Fms, Ww, Ww, Gs^Fms, Gs^Fms, Hh, Gs^Fms, Hh, Gs, Hh, Gs^Fms, Gs^Fms, Gs^Fms, Gs^Fms, Ww, Ww, Mm, Mm, Mm
Md^Xm, Md^Xm, Md^Xm, Md^Xm, Md^Xm, Mm, Mm, Mm, Mm, Gs^Fms, Gs^Fms, Gs^Fms, Re, Gs^Fms, Gs^Fms, Gs^Fms, Gs^Fms, Ww, Ww, Gs^Fms, Gs^Fms, Gs^Fms, Gs^Fms, Gs, Gs^Fms, Gs^Fms, Ww, Ww, Gs^Fms, Mm, Mm, Mm, Mm
Mm, Md^Xm, Md^Xm, Md^Xm, Mm, Mm, Mm, Mm, Hh, Gs^Fms, Gs^Fms, Gs^Fms, Re, Gs, Gs, Gs, Gs, Gs^Fms, Ww, Ww, Ww, Ww, Ww, Ww, Ww, Ww, Gs^Fms, Gs^Fms, Hh, Mm, Mm, Mm, Mm
Gs^Fds, Hh, Gs^Fds, Hh, Hh, Mm, Mm, Mm, Hh, Gs^Fms, Gs^Fms, Re, Gs^Fms, Gs^Fms, Gs^Fms, Gs^Fms, Gll^Fp, Gg, Ww^Bw\, Gs^Vh, Gs, Gs, Gs^Fms, Gs^Fms, Gs^Fms, Gs^Fms, Gs^Fms, Gs^Fms, Hh, Mm, Mm, Mm, Mm
Re, Gs^Fds, Re, Gs^Fds, Gs^Fms, Hh, Gs^Fms, Hh, Gs^Fms, Gs^Fms, Gs^Fms, Re, Gs^Fms, Gs^Fms, Gs^Fds, Gs^Fms, Gs^Fms, Gs^Fms, Ww, Gg, Gs^Fms, Gs^Fms, Hh, Hh, Hh, Hh, Mm, Hh, Hh, Hh, Mm, Mm, Mm
Gs^Fds, Re, Gs^Fms, Re, Re, Gs^Fms, Re, Gs^Fms, Gs^Fms, Gs^Fms, Gs^Fms, Re, Gs^Fms, Gs^Fms, Gs^Fds, Gs^Fds, Gg^Ve, Gs^Fds, Ww, Gs^Fms, Hh, Hh, Md, Hh, Mm, Mm, Mm, Mm, Mm, Mm, Md^Xm, Md^Xm, Md^Xm
Gs^Fds, Gs^Fds, Gs^Fds, Gs^Fms, Gs^Fds, Re, Gs^Fms, Re, Re, Gs^Fms, Gs^Fms, Re, Gs^Fms, Gs^Fms, Gs^Fms, Gs^Fds, Gs^Fds, Gs^Fms, Ww, Hh, Md, Md, Md, Md, Md^Xm, Mm, Md^Xm, Mm, Ms^Xm, Md^Xm, Ms^Xm, Md^Xm, Md^Xm
Gs^Fms, Mm, Gs^Fms, Gs^Fds, Gs^Fds, Gs^Fds, Gs^Fms, Gs^Fds, Gs^Fds, Re, Re, Re, Gs^Fms, Gs^Fms, Gs^Fds, Gs^Fds, Ww, Ww, Md, Md, Mm, Mm, Md^Xm, Md^Xm, Ms^Xm, Ms^Xm, Ms^Xm, Ms^Xm, Ms^Xm, Ms^Xm, Md^Xm, Md^Xm, Mm
Gs^Fms, Gs^Fms, Gs^Fms, Gs^Fms, Gs^Fms, Gs^Fms, Gs^Fms, Gs^Fds, Gs^Fms, Gs^Fds, Re, Gs, Gs, Gs^Fds, Gll^Fmw, Hh, Ww, Md, Md, Md, Md, Md^Xm, Md, Ms^Xm, Aa, Md^Xm, Aa, Aa, Ai, Aa, Mm, Md^Xm, Mm
Gs^Fms, Gs^Fms, Gs^Fms, Gs^Fms, Gs^Fms, Gs^Fms, Gs^Fms, Gs^Fms, Gs, Gs, Re, Gs, Gs, Gs^Fms, Gs^Fms, Gll^Fmw, Ww, Hhd, Gll^Fmw, Md, Gll^Fmw, Md, Md, Ha, Ha, Aa, Ai, Ww, Ww, Ww, Ha, Aa, Ha
Gg, Gs^Fms, Gs^Fms, Gs^Fms, Gs^Vc, Gs^Es, Gs, Gs, Gs, Gs, Re, Gs, Gs, Gs, Gs, Gs^Fms, Gs^Fms, Ww, Ww, Gll^Fmw, Gs^Fms, Gll^Fmw, Gll^Fmw, Md, Hhd, Ha, Ai, Ww, Ww, Ai, Hhd, Ha, Md
Gs, Gs, Gs, Gs, Gs, Gs, Gs, Gs, Gs^Es, Gs, Re, Gs, Gs, Gs, Gs, Gs, Gs, Gs^Fms, Gs^Fms, Ww, Ww, Ww, Ww, Gll^Fmw, Gll^Fmw, Ww, Ww, Ww, Ww, Ww, Gll^Fmw, Md, Md
Gs, Gs^Es, Gs, Gs, Gs, Gs, Gs, Gs^Es, Gs, Gs, Re, Gs, Gs, Gs, Gs, Gs^Es, Gs, Gs, Gs, Gs^Fms, Gs^Fms, Gs^Fms, Gs^Fms, Ww, Ww, Ww, Ww, Ww, Ww, Gll^Fmw, Gll^Fmw, Gll^Fmw, Gll^Fmw
Gs, Gs, Gs, Gs, Gs, Gs, Gs^Efm, Gs, Gs, Gs, Re, Gs^Efm, Gg, Gs, Gg^Efm, Gs, Gs, Gs^Vc, Gs^Fms, Gs^Fms, Gs^Fms, Gs^Fms, Gs^Fms, Ww, Ww, Ww, Ww, Ww, Gs^Fms, Gs^Fms, Gs^Fms, Gll^Fmw, Gs^Fms
Gs^Fms, Gg^Efm, Gg^Efm, Gg^Efm, Gg^Efm, Gg^Efm, Gg^Efm, Gg^Efm, Gg^Efm, Gg^Efm, Gg^Efm, Re, Gg^Efm, Gg^Efm, Gg^Efm, Gg^Efm, Gg^Efm, Gg^Efm, Gs^Fms, Gs^Fms, Gs^Fms, Gs^Fms, Ww, Ww, Ww, Ww, Ww, Gs^Fms, Gs^Fms, Gs^Fms, Gs^Fms, Gs^Fms, Gs^Fms
Gs^Fms, Gs^Fms, Gg^Efm, Gg^Efm, Gg^Es, Gg^Efm, Gg^Efm, Gg^Efm, Gg^Efm, Gg^Efm, Gg^Efm, Re, Gg^Efm, Gg^Efm, Gs^Fms, Gs^Fms, Gs^Fms, Gs^Fms, Gs^Fms, Gs^Fms, Ww, Ww, Ww, Ww, Ww, Ww, Mm, Mm, Mm, Mm, Hh, Gs^Fms, Rb^Gvs
Gs^Fms, Gs^Fms, Gs^Fms, Gg^Efm, Gs^Fms, Gg^Efm, Gg^Efm, Gg^Efm, Gs^Fms, Gg^Efm, Gs^Fms, Re, Gs^Fms, Gs^Fms, Gs^Fms, Gs^Fms, Gs^Fms, Gs^Fms, Gs^Fms, Gs^Fms, Ww, Ww, Ww, Ww, Ww, Mm, Mm, Mm, Mm, Hh, Rb^Gvs, Rb^Gvs, Rb^Gvs
Gs^Fms, Gs^Fms, Gs^Fms, Gs^Fms, Gs^Fms, Gs^Fms, Gs^Fms, Gs^Fms, Gs^Fms, Gs^Fms, Gs^Fms, Re, Gs^Fms, Gs^Fms, Gs^Fms, Gs^Fms, Gs^Fms, Gs^Fms, Ww, Ww, Ww, Ww, Ww, Ww, Mm, Ww, Ww, Mm, Hh^Vhh, Rb^Gvs, Rb^Gvs, Rb^Gvs, Rb^Gvs
Gs^Fms, Gs^Fms, Gs^Fms, Gs^Fms, Gs^Fms, Gs^Fms, Gs^Fms, Gs^Fms, Gs^Fms, Gs^Fms, Gs^Fms, Re, Gs^Fms, Gs^Fms, Ww, Gs^Fms, Ww, Ww, Ww, Ww, Ww, Ww, Ww, Mm, Mm, Mm, Hh, Ww, Ww^Bw/, Gs, Gs, Rb^Gvs, Gs^Vh
Gs^Fms, Gs^Fms, Gs^Fms, Gs^Fms, Gs^Fms, Gs^Fms, Ww, Gs^Fms, Ww, Gs^Fms, Wwr, Ww^Bw|, Wwr, Ww, Ww, Ww, Ww, Ww, Ww, Ww, Ww, Ww, Mm, Mm, Mm, Mm, Gs, Gs, Gs, Ww, Gs, Gs, Gs
Ww, Ww, Ww, Ww, Ww, Ww, Ww, Ww, Ww, Ww, Wwr, Ww^Bw|, Wwr, Ww, Ww, Ww, Ww, Ww, Mm, Mm, Mm, Ww, Hh, Mm, Gs, Gs^Vh, Gs, Gs, Gs, Ww, Ww, Gs, Gs
Ww, Ww, Ww, Ww, Ww, Ww, Ww, Ww, Ww, Ww, Wwr, Ww^Bw|, Gg, Ww, Gg^Es, Hh, Mm, Mm, Mm, Mm, Hh, Ww, Gs, Gs, Gs, Gs, Gs, Gs, Gs, Gs, Gs^Es, Ww, Mm
Gs^Fms, Ww, Gs^Fms, Ww, Gs^Fms, Ww, Gg^Es, Ww, Gg^Es, Gg^Efm, Gg^Efm, Re, Gg^Efm, Gg^Es, Gg^Efm, Hh, Hh, Mm, Mm, Hh, Gs, Ww, Gs, Gs, Hh, Hh, Hh^Vhh, Hh, Mm, Gs, Mm, Mm, Mm
Hh, Hh, Mm, Mm, Hh, Gs^Fms, Gg^Efm, Gg^Efm, Gg^Efm, Gg^Efm, Gg^Efm, Re, Gg^Efm, Gg^Efm, Gg^Efm, Gg^Es, Gg, Hh, Gs, Gs, Gs, Ww^Bw/, Mm, Hh, Mm, Mm, Mm, Mm, Mm, Mm, Hh, Mm, Hh
Mm, Mm, Mm^Cov, Mm^Cov, Mm^Cov, Gg, Gg^Es, Gg^Efm, Gg^Efm, Gg^Efm, Gg^Efm, Re, Gg^Efm, Gg^Efm, Gg^Efm, Gs^Efm, Gs, Gs, Gs, Gs, Gs, Ww, Ww, Mm, Hh, Hh, Hh, Hh, Hh, Hh, Hh, Hh, Hh
Mm, Mm, Mm^Cov, Mm^Cov, Gg^Kov, Gs, Gg, Gg^Efm, Gg^Efm, Gg^Efm, Gg^Efm, Re, Gg, Gg^Efm, Gg^Efm, Gg^Efm, Gs^Fms, Gs, Gs^Fms, Gs, Gs^Fms, Gs^Vc, Rb^Gvs, Ww, Ww, Ww, Ww, Gs^Fms, Ww, Gs^Fms, Ww, Gs^Fms, Ww
Mm, Mm, Mm^Cov, Mm^Cov, Mm^Cov, Gs, Gg, Gg^Efm, Gg^Efm, Gg^Efm, Gs, Re, Gs, Gg, Gs^Fms, Gs^Fms, Gs^Fms, Gs^Fms, Gs^Fms, Gs^Fms, Gs^Fms, Gs^Fms, Gs^Fms, Gs^Fms, Gs^Fms, Ww, Gs^Fms, Ww, Gs^Fms, Ww, Gs^Fms, Ww, Gs^Fms
Mm, Mm, Mm, Mm^Cov, Hh^Cov, Gs, Gs^Fms, Gg, Gg^Es, Gs, Gs, Re, Gs, Gs^Fms, Gs^Fms, Gs^Fms, Gs^Fds, Gs^Fms, Gs^Fms, Gs^Fms, Gg^Ve, Gs^Fms, Gs^Fds, Gs^Fms, Gs^Fms, Gs^Fms, Gs^Fms, Gs^Fms, Gs^Fds, Gs^Fms, Gs^Fds, Gs^Fds, Gs^Fds
Mm, Mm, Gs^Fms, Mm, Gs^Fms, Gs^Fms, Gs^Fms, Gs^Fms, Gs^Fms, Gs^Fms, Gs, Re, Gs^Fms, Gs^Fms, Gs^Fds, Gs^Fds, Gs^Fds, Gs^Fds, Gs^Fds, Gs^Fds, Gs^Fds, Gs^Fds, Gs^Fds, Gs^Fds, Gs^Fds, Gs^Fds, Gs^Fds, Gs^Fds, Gs^Fds, Gs^Fds, Gs^Fds, Gs^Fds, Hh
Gg, Gs^Fms, Gs^Fms, Gg^Ve, Gs^Fms, Gs^Fms, Gs^Fms, Gs^Fms, Gs^Fms, Gs^Fms, Re, Re, Gs^Fms, Gs^Fms, Gs^Fds, Gs^Fds, Hh, Hh, Hh, Gs^Fds, Hh, Gs^Fds, Hh, Gs^Fds, Hh, Gs^Fds, Hh, Gs^Fds, Hh, Gs^Fds, Mm, Mm, Mm
Gs^Fms, Gs^Fms, Gs^Fds, Gs^Fms, Gs^Fms, Gs^Fms, Gs^Fms, Gs^Fms, Gs^Fms, Gs^Fms, Re, Gs^Fms, Gs^Fms, Gs^Fds, Hh, Hh, Mm, Mm, Mm, Mm, Mm, Mm, Mm, Hh, Mm, Mm, Mm, Mm, Mm, Mm, Mm^Xm, Mm^Xm, Mm^Xm
Mm, Gs^Fds, Mm, Gs^Fds, Gs^Fds, Gs^Fds, Gs^Fds, Gs^Fds, Cvr, Gs^Fms, Re, Gs^Fms, Cvr, Gs^Fds, Mm, Mm, Mm^Xm, Mm, Mm^Xm, Mm, Mm, Mm, Mm, Mm, Mm, Mm, Mm^Xm, Mm, Mm^Xm, Mm^Xm, Ms^Xm, Mm^Xm, Ms^Xm
Md^Xm, Mm, Mm, Mm, Mm, Mm, Mm, Cvr, Hh, Kvr, Re, Kvr, Gs^Fms, Cvr, Mm, Mm^Xm, Mm^Xm, Mm^Xm, Mm^Xm, Mm^Xm, Mm^Xm, Mm^Xm, Mm^Xm, Mm^Xm, Mm^Xm, Mm^Xm, Mm^Xm, Mm^Xm, Mm^Xm, Ms^Xm, Mm^Xm, Mm^Xm, Mm^Xm
Md^Xm, Md^Xm, Md^Xm, Mm, Mm, Mm, Mm, Mm, Mm, Hh, Re, Gs^Fms, Gs^Fms, Gs^Fds, Hh, Mm, Mm, Mm^Xm, Mm, Mm^Xm, Mm^Xm, Md^Xm, Md^Xm, Md^Xm, Md^Xm, Mm^Xm, Mm^Xm, Mm^Xm, Mm, Mm^Xm, Mm, Mm, Ww
Md^Xm, Md^Xm, Md^Xm, Md^Xm, Md^Xm, Mm, Mm, Mm, Mm, Hh, Hh, Re, Re, Gs^Fms, Gs^Fms, Hh, Hh, Mm, Mm, Mm, Mm, Md^Xm, Mm, Mm, Mm, Mm, Mm, Mm, Mm, Mm, Hh, Ww, Ww
Md^Xm, Md^Xm, Md^Xm, Md^Xm, Md^Xm, Md^Xm, Md^Xm, Mm, Mm, Hh, Mm, Hh, Hh, Re, Re, Gg, Gg, Hh, Hh, Mm, Mm, Mm, Mm, Mm, Mm, Mm, Mm, Mm, Mm, Hh, Ww, Ww, Gs^Fms
Md^Xm, Md^Xm, Mm, Mm, Mm, Mm, Mm, Mm, Mm, Mm, Mm, Hh, Hh, Gg, Gg, Re, 1 Re, 2 Gg, Gg, Hh, Hh, Mm, Mm, Mm, Mm, Mm, Mm, Mm, Hh, Hh, Ww, Gg, Gg
Mm, Mm, Mm, Mm, Mm, Mm, Mm, Mm, Mm, Mm, Mm, Mm, Hh, Hh, Hh, Gg, Gg, Re, Re, Gg, Hh, Hh, Hh, Hh^Vhh, Hh, Mm, Hh, Hh, Hh, Hh, Ww, Gg^Efm, Gg^Efm
