Ms^Xm, Ms^Xm, Ms^Xm, Ms^Xm, Ms^Xm, Ms^Xm, Ms, Ms^Xm, Re, Mm, Ms, Mm, Ms, Mm, Ms^Xm, Ms^Xm, Ms^Xm, Ms^Xm, Ms^Xm, Ms^Xm, Ms^Xm, Ms^Xm, Ms^Xm, Ms^Xm, Ms^Xm, Ms^Xm, Ms, Ms, Ms, Ms, Ms^Xm, Ms, Ms
Ms^Xm, Ms^Xm, Ms^Xm, Ms^Xm, Ms, Ms, Ms, Ms, Re, Ms, Ms, Ms, Ha^Vhha, Ms, Ms, Ms, Ms, Ms, Ms, Ms, Ha, Ha, Ha, Ms, Ms, Ms, Ms, Ms, Ms, Ms, Ms^Xm, Ms^Xm, Ms^Xm
Ms^Xm, Ms^Xm, Ms, Ms, Ms, Ms, Ms, Ms, Re, Ms, Ha, Ha, Aa^Fpa, Aa^Fpa, Aa^Fpa, Aa^Fpa, Cha, Kha^Ii, Cha, Cha, Cha, Kha^Ii, Cha, Cha, Cha, Kha^Ii, Cha, Ms, Ha, Ms, Ms, Ms^Xm, Ms
Mm, Ms, Ms, Ms, Mm, Mm, Mm, Mm, Re, Hh, Aa^Fpa, Aa^Fpa, Aa^Fpa, Aa^Fpa, Kha^Ii, Cha, Rrc, Rr^Vhc, Rrc, Rrc, Rrc, Rr^Vhc, Rrc, Gg^Efm, Gg^Efm, Rr^Vhc, Gg^Efm, Cha, Kha^Ii, Ms, Ms, Ms, Ms
Mm, Mm, Mm, Mm, Mm, Mm, Hh^Vhh, Hh, Re, Aa^Fpa, Gs^Fms, Aa^Fpa, Aa^Fpa, Aa, Ch, Rr^Vhc, Rrc, Rrc, Kh, Kh, Kh, Rrc, Kh, Kh, Kh, Gg^Efm, Gg^Efm, Gg^Fet, Gg^Efm, Cha, Ha, Ms, Ms
Mm, Mm, Mm, Mm, Hh, Hh, Gg, Gs^Fms, Re, Gs^Fms, Gs^Fms, Gs^Fms, Gg, Kh^Ii, Rrc, Rrc, Kh, Kh, Rrc, Rrc, Rrc, Rrc, Rrc, Kh, Rrc, Kh, Kh, Gg^Efm, Kh, Cha, Ms^Xm, Ha, Ha
Mm, Mm, Mm, Mm, Gs^Fms, Gs^Fms, Gg, Gg, Gs^Fms, Re, Re, Gg, Rrc, Rrc, Rrc, Rrc, Kh, Kh, Rrc, Rrc, Rrc, Rrc, Rrc, Rrc, Rrc, Kh, Kh, Kh, Kh, Kha^Ii, Ms^Xm, Ms^Xm, Ms^Xm
Mm, Mm, Gs^Fms, Gs^Fms, Gs^Fms, Gg^Vwm, Gg, Gs^Fms, Gs^Fms, Gs^Fms, Re, Rrc, Gg, Kh^Ii, Ch, Rrc, Rrc, Kh, Kh, Rrc, Kh, Rrc, Kh, Kh, Kh, Kh, Gg^Efm, Gg^Efm, Gg^Efm, Ch, Mm, Ms^Xm, Ms^Xm
Ww, Mm, Ww, Gs^Fms, Gs^Fms, Gs^Fms, Gs^Fms, Gs^Fms, Gs^Fms, Gs^Fms, Gs^Fms, Re, Re, Gg, Kh^Ii, Rr^Vhc, Rrc, Rrc, Rrc, Kh, Rrc, Rrc, Rrc, Kh, Gg^Efm, Gg^Efm, Gg^Efm, Gg^Fet, Kh^Ii, Ch, Mm, Ms^Xm, Ms^Xm
Mm, Ww, Gs^Fms, Ww, Ww, Ww, Ww, Gs^Fms, Gs^Fms, Gs^Fms, Gs^Fms, Gs^Fms, Gs^Fms, Re, Gs^Fms, Ch, Ch, Rrc, Rr^Vhc, Rrc, Rrc, Rrc, Gg^Efm, Gg^Efm, Gg^Efm, Rr^Vhc, Ch, Ch, Mm, Hh, Mm, Ms^Xm, Ms^Xm
Mm, Mm, Hh, Gs^Fms, Gs^Vh, Gs^Fms, Gs^Fms, Ww, Ww, Gs^Fms, Gs^Fms, Gs^Fms, Gs^Fms, Re, Gs^Fms, Gs^Fms, Gs^Fms, Kh^Ii, Ch, Rrc, Ch, Rr^Vhc, Ch, Gg^Efm, Ch, Kh^Ii, Ms^Xm, Mm, Ms^Xm, Mm, Ms^Xm, Ms^Xm, Ms^Xm
Mm, Mm, Mm, Hh, Hh, Gg, Gg, Gg, Gg, Ww, Ww, Gs^Fms, Re, Re, Gs^Fms, Gs^Fms, Gs^Fms, Gs^Fms, Hh, Ch, Mm, Kh^Ii, Mm, Ms^Xm, Ms^Xm, Ms^Xm, Ms^Xm, Ms^Xm, Ms^Xm, Ms^Xm, Mm, Ms^Xm, Mm
Mm, Mm, Mm, Mm, Mm, Hh, Hh, Hh, Hh, Gg, Gg, Wwr, Ww^Bw|, Gs^Fms, Gs^Fms, Gs^Fms, Gs^Fms, Gs^Fms, Gs^Fms, Hh, Hh, Mm, Mm, Mm, Mm, Ms^Xm, Mm, Ms^Xm, Mm, Mm, Mm, Mm, Ww
Md^Xm, Mm, Mm, Mm, Mm, Mm, Mm, Mm, Hh, Gs^Fms, Gs^Fms, Gg, Re, Wwr, Ww, Gs^Fms, Gs^Fms, Gg, Gg, Gs^Fms, Gg, Hh, Hh^Vhh, Mm, Mm, Mm, Hh, Mm, Mm, Mm, Ww, Ww, Mm
Md^Xm, Md^Xm, Md^Xm, Mm, Mm, Mm, Mm, Mm, Gs^Fms, Gs^Fms, Gs^Fms, Gs^Fms, Re, Gs^Fms, Gs^Fms, Ww, Ww, Gs^Fms, Gs^Fms, Gg, Gs^Fms, Gg, Gg, Hh, Gs^Fms, Gs^Fms, Gs^Fms, Gs^Fms, Ww, Ww, Mm, Mm, Mm
Md^Xm, Md^Xm, Md^Xm, Md^Xm, Md^Xm, Mm, Mm, Mm, Mm, Gs^Fms, Gs^Fms, Gs^Fms, Re, Gs^Fms, Gs^Fms, Gs^Fms, Gs^Fms, Ww, Ww, Gs^Fms, Gs^Fms, Gs^Fms, Gs^Fms, Gg, Gs^Fms, Gs^Fms, Ww, Ww, Gs^Fms, Mm, Mm, Mm, Mm
Mm, Md^Xm, Md^Xm, Md^Xm, Mm, Mm, Mm, Mm, Hh, Gs^Fms, Gs^Fms, Gs^Fms, Re, Gg, Gg, Gg, Gg, Gs^Fms, Gs^Fms, Ww, Ww, Ww, Ww, Ww, Ww, Ww, Gs^Fms, Gs^Fms, Hh, Mm, Mm, Mm, Mm
Gs^Fds, Hh, Gs^Fds, Hh, Hh, Mm, Mm, Mm, Hh, Gs^Fms, Gs^Fms, Re, Gs^Fms, Gs^Fms, Gs^Fms, Gs^Fms, Gll^Fp, Gg, Gg, Gs^Vh, Gg, Gg, Gs^Fms, Gs^Fms, Gs^Fms, Gs^Fms, Gs^Fms, Gs^Fms, Hh, Mm, Mm, Mm, Mm
Re, Gs^Fds, Re, Gs^Fds, Gs^Fms, Hh, Gs^Fms, Hh, Gs^Fms, Gs^Fms, Gs^Fms, Re, Gs^Fms, Gs^Fms, Gs^Fds, Gs^Fms, Gs^Fms, Gs^Fms, Gs^Fms, Gs^Fms, Gs^Fms, Gs^Fms, Hh, Hh, Hh, Hh, Mm, Hh, Hh, Hh, Mm, Mm, Mm
Gs^Fds, Re, Gs^Fms, Re, Re, Gs^Fms, Re, Gs^Fms, Gs^Fms, Gs^Fms, Gs^Fms, Re, Gs^Fms, Gs^Fms, Gs^Fds, Gs^Fds, Gs^Fds, Gs^Fds, Gs^Fms, Gs^Fms, Hh, Hh, Mm, Hh, Mm, Mm, Mm, Mm, Mm, Mm, Md^Xm, Md^Xm, Md^Xm
Gs^Fds, Gs^Fds, Gs^Fds, Gs^Fms, Gs^Fds, Re, Gs^Fms, Re, Re, Gs^Fms, Gs^Fms, Re, Gs^Fms, Gs^Fms, Gs^Fms, Gs^Fds, Gs^Fds, Gs^Fms, Hh, Hh, Mm, Mm, Mm, Mm, Md^Xm, Mm, Md^Xm, Mm, Ms^Xm, Md^Xm, Ms^Xm, Md^Xm, Md^Xm
Mm, Mm, Mm, Gs^Fds, Gs^Fds, Gs^Fds, Gs^Fms, Gs^Fds, Gs^Fds, Re, Re, Re, Gs^Fms, Gs^Fms, Gs^Fds, Gs^Fds, Hh, Hh, Mm, Mm, Mm, Mm, Md^Xm, Md^Xm, Ms^Xm, Ms^Xm, Ms^Xm, Ms^Xm, Ms^Xm, Ms^Xm, Md^Xm, Md^Xm, Mm
Md^Xm, Mm, Mm, Mm, Mm, Mm, Mm, Gs^Fds, Hh, Gs^Fds, Re, Gs^Fds, Gs^Fds, Gs^Fds, Hh, Hh, Mm, Mm, Mm, Mm, Md^Xm, Md^Xm, Ms^Xm, Ms^Xm, Md^Xm, Md^Xm, Mm, Md^Xm, Mm, Md^Xm, Mm, Md^Xm, Mm
Md^Xm, Md^Xm, Md^Xm, Mm, Mm, Mm, Mm, Mm, Mm, Hh, Re, Gs^Fds, Gs^Fds, Gs^Fds, Hh, Mm, Mm, Mm, Mm, Mm, Mm, Md^Xm, Md^Xm, Md^Xm, Md^Xm, Md^Xm, Mm, Mm, Hh, Mm, Hh, Mm, Ww
Md^Xm, Md^Xm, Md^Xm, Md^Xm, Md^Xm, Mm, Mm, Mm, Mm, Hh, Hh, Re, Re, Gs^Fds, Gs^Fds, Hh, Hh, Mm, Mm, Mm, Mm, Md^Xm, Mm, Md^Xm, Mm, Mm, Mm, Mm, Mm, Hh, Hh, Ww, Ww
Md^Xm, Md^Xm, Md^Xm, Md^Xm, Md^Xm, Md^Xm, Md^Xm, Mm, Mm, Hh, Mm, Hh, Hh, Re, Re, Gg, Gg, Hh, Hh, Mm, Mm, Mm, Mm, Mm, Mm, Mm, Mm, Mm, Mm, Hh, Ww, Ww, Gs^Fms
Md^Xm, Md^Xm, Mm, Mm, Mm, Mm, Mm, Mm, Mm, Mm, Mm, Hh, Hh, Gg, Gg, Re, Re, Gg, Gg, Hh, Hh, Mm, Mm, Mm, Mm, Mm, Mm, Mm, Hh, Hh, Ww, Gg, Gg
Mm, Mm, Mm, Mm, Mm, Mm, Mm, Mm, Mm, Mm, Mm, Mm, Hh, Hh, Hh, Gg, Gg, Re, Re, Gg, Hh, Hh, Hh, Hh^Vhh, Hh, Mm, Hh, Hh, Hh, Hh, Ww, Gg^Efm, Gg^Efm
Mm, Mm, Mm, Mm, Mm, Mm, Hh, Hh, Hh, Mm, Hh, Mm, Hh, Hh, Hh, Gg, Gg, Gg, Re, Gg, Gg, Hh, Gg, Hh, Hh, Hh, Gg, Gg, Gg, Ww, Gg^Efm, Gg^Efm, Gg^Efm
