Xu, Xu, Xu, Xu, Xu, Xu, Xu, Xu, Xu^Xo, Qxu, Qxu, Qxu, Qxu, Xu, Xu, Xu, Xu, Xu, Xu, Xu, Xu, Xu, Uu, Uu^Ii, Ur^Ii, Xu, Xu, Xu, Qxu, Qxu, Qxu, Qxu, Qxu, Qxu, Qxu, Qxu, Qxu, Qxu, Qxu, Xu, Xu, Xu, Xu, Xu
Qxu, Xu, Qxu, Xu, Qxu, Xu, Qxu^Xo, Xu^Xo, Qxu^Xo, Xu^Xo, Qxu, Qxu, Qxu, Qxu, Xu, Xu, Xu, Xu, Xu, Xu, Xu, Xu, Qxu, Uu, Ur, Uu, Qxu, Qxu, Qxu, Qxu, Qxu, Qxu, Qxu, Qxu, Qxu, Qxu, Qxu, Qxu, Xu, Xu, Xu, Xu, Xu, Xu
Qxu, Qxu, Qxu, Qxu, Qxu, Qxu, Qxu^Xo, Qxu^Xo, Qxu^Xo, Qxu^Xo, Qxu, Qxu, Ur, Ur, Ur, Ur, Ur, Xu, Ur, Xu, Qxu, Qxu, Qxu, Qxu, Qxu^Bs|, Qxu, Qxu, Qxu, Qxu, Qxu, Uu^Vu, Xu, Xu, Xu, Xu, Qxu, Xu, Xu, Uu^Uf, Xu, Xu, Xu, Qxu, Qxu
Qxu, Qxu, Qxu, Qxu, Qxu, Qxu, Qxu^Xo, Qxu^Xo, Qxu^Xo, Qxu^Xo, Qxu, Qxu, Ur, Qxu, Qxu, Qxu, Qxu, Ur, Qxu, Ur, Qxu^Bs\, Qxu, Qxu, Qxu, Qxu^Bs|, Qxu, Qxu, Qxu, Qxu^Bs/, Ur, Ur, Xu, Xu, Xu, Xu, Xu, Ur, Ur, Ur, Xu, Qxu, Qxu, Qxu, Qxu
Xu, Qxu, Xu, Qxu, Xu, Xu, Xu, Qxu^Xo, Qxu^Xo, Qxu^Xo, Xu, Qxu, Xu, Ur, Ur, Qxu, Qxu, Qxu, Qxu, Qxu, Qxu, Qxu^Bs\, Qxu^Bs\, Qxu, Qxu^Bs|, Qxu, Qxu^Bs/, Qxu^Bs/, Qxu, Qxu, Qxu, Ur, Ur, Ur, Ur, Xu, Ur, Qxu, Qxu, Ur, Qxu, Qxu, Qxu, Qxu
Xu, Xu, Xu, Xu, Xu, Xu, Xu, Xu, Xu, Xu, Xu, Xu, Xu, Uu^Vu, Xu, Ur, Ur, Qxu, Qxu, Qxu, Qxu, Qxu, Qxu, Ur, Ur, Ur, Qxu, Qxu, Qxu, Qxu, Qxu, Qxu, Qxu, Qxu, Qxu, Ur, Qxu, Qxu, Uh, Ur, Uh, Qxu, Xu, Qxu
Xu, Xu, Xu, Xu, Xu, Xu, Xu, Xu, Xu, Xu, Xu, Xu, Xu, Xu, Xu, Uh, Uu^Ii, Uh, Xu, Qxu, Qxu, Qxu, Qxu, Ur, Ur, Ur, Qxu, Qxu, Xu, Qxu, Xu, Qxu, Xu, Qxu, Qxu, Qxu, Qxu, Qxu, Uh, Uu^Ii, Uh, Qxu, Xu, Xu
Xu, Xu, Xu, Xu, Xu, Xu, Xu, Xu, Xu, Xu, Xu, Xu, Xu, Xu, Xu, Uh, Uh, Uh, Xu, Xu, Qxu, Qxu, Qxu, Ur, Ur, Xu, Xu, Xu, Xu, Xu, Xu, Xu, Xu, Xu, Xu, Qxu, Qxu, Qxu, Qxu, Uh, Qxu, Qxu, Qxu, Xu
Xu, Xu, Xu, Xu, Xu, Xu, Xu, Xu, Xu, Xu, Xu, Xu, Xu, Xu, Xu, Xu, Xu, Xu, Xu, Xu, Xu, Qxu, Qxu, Ur, Ur, Ur, Xu, Xu, Xu, Xu, Xu, Xu, Xu, Xu, Xu, Xu, Xu, Xu, Xu, Xu, Qxu, Qxu, Qxu, Xu
Xu, Xu, Xu, Xu, Qxu, Xu, Qxu, Xu, Xu, Xu, Xu, Xu, Xu, Xu, Xu, Xu, Xu, Xu, Xu, Xu, Xu, Qxu, Qxu, Uu^Vu, Ur, Ur, Ur, Xu, Xu, Xu, Xu, Xu, Xu, Xu, Xu, Xu, Xu, Xu, Xu, Xu, Xu, Qxu, Qxu, Xu
Xu, Xu, Xu, Qxu, Qxu, Qxu, Qxu, Qxu, Qxu, Xu, Xu, Xu, Xu, Qxu, Qxu, Xu, Qxu, Qxu, Qxu, Qxu, Qxu, Qxu, Qxu, Qxu, Uu, Uu, Uu, Ur, Ur, Xu, Ur, Xu, Xu, Xu, Xu, Xu, Xu, Xu, Xu, Xu, Xu, Xu, Xu, Xu
Xu, Xu, Xu, Xu, Qxu, Qxu, Qxu, Qxu, Qxu, Qxu, Qxu, Qxu, Qxu, Qxu, Qxu, Qxu, Qxu, Qxu, Qxu, Qxu, Qxu, Qxu, Xu, Qxu, Qxu, Uh, Uh, Uu, Uu, Ur, Uu, Ur, Uu^Vu, Xu, Xu, Xu, Xu, Xu, Xu, Xu, Xu, Xu, Xu, Xu
Xu, Xu, Xu, Qxu, Xu, Xu, Xu, Qxu, Xu, Qxu, Qxu, Qxu, Qxu, Qxu, Qxu, Qxu, Xu, Qxu, Xu, Qxu, Xu, Xu, Xu, Xu, Qxu, Qxu, Qxu, Uh, Uh, Uu, Uu, Ur, Ur, Xu, Xu, Xu, Xu, Xu, Xu, Xu, Xu, Xu, Xu, Xu
Xu, Xu, Qxu, Qxu, Xu, Xu, Xu, Xu, Qxu, Qxu, Qxu, Qxu, Xu, Xu, Xu, Xu, Xu, Xu, Xu, Xu, Xu, Xu, Xu, Xu, Xu, Qxu, Qxu, Qxu, Qxu, Uh, Uh, Uu, Ur, Xu, Xu, Xu, Xu, Xu, Xu, Xu, Xu, Xu, Xu, Xu
Xu, Qxu, Qxu, Qxu, Qxu, Xu, Xu, Qxu, Qxu, Qxu, Qxu, Xu, Xu, Xu, Xu, Xu, Xu, Xu, Xu, Xu, Xu, Xu, Xu, Xu, Xu, Xu, Qxu, Qxu, Qxu, Qxu, Uh, Uu, Uu, Ur, Xu, Xu, Xu, Xu, Xu, Xu, Xu, Xu, Xu, Xu
Xu, Qxu, Qxu, Qxu, Qxu, Xu, Qxu, Qxu, Qxu, Qxu, Qxu, Xu, Xu, Xu, Xu, Xu, Xu, Xu, Qxu, Xu, Qxu, Xu, Xu, Xu, Xu, Xu, Xu, Qxu, Qxu, Qxu, Qxu, Uh, Uu, Ur, Uu, Xu, Xu, Xu, Xu, Xu, Xu, Xu, Xu, Xu
Xu, Qxu, Qxu, Qxu, Qxu, Qxu, Qxu, Qxu, Qxu, Qxu, Qxu^Xo, Xu, Xu, Xu, Xu, Xu, Xu, Qxu, Qxu, Qxu, Qxu, Qxu, Qxu, Xu, Qxu, Xu, Qxu, Qxu, Qxu, Qxu, Qxu, Uh, Uu, Ur, Qxu, Xu, Xu, Xu, Xu, Xu, Xu, Xu, Xu, Xu
Qxu, Qxu, Qxu, Qxu, Qxu, Qxu, Qxu, Qxu, Qxu^Xo, Qxu^Xo, Qxu^Xo, Qxu^Xo, Qxu^Xo, Xu, Xu, Xu, Xu, Xu, Xu, Qxu, Qxu, Qxu, Qxu, Qxu, Qxu, Qxu, Qxu, Qxu, Qxu, Qxu, Ur, Qxu, Ur, Ur, Qxu, Qxu, Xu, Xu, Xu, Xu, Xu, Xu, Xu, Xu
Qxu, Qxu, Qxu, Qxu, Qxu, Qxu, Qxu^Xo, Qxu^Xo, Qxu^Xo, Qxu^Xo, Qxu^Xo, Qxu^Xo, Qxu^Xo, Qxu^Xo, Qxu^Xo, Xu, Xu, Xu, Xu, Xu, Xu, Xu, Qxu, Qxu, Qxu, Qxu, Qxu, Qxu, Ur, Ur, Qxu, Ur, Qxu, Qxu, Qxu, Qxu, Qxu, Xu, Xu, Xu, Qxu, Xu, Qxu, Xu
Xu, Qxu, Qxu, Qxu, Qxu^Xo, Qxu^Xo, Qxu^Xo, Qxu^Xo, Qxu^Xo, Qxu^Xo, Qxu^Xo, Qxu^Xo, Qxu^Xo, Qxu^Xo, Qxu^Xo, Xu, Xu, Xu, Uu^Vu, Xu, Uu, Xu, Uu, Qxu, Uu, Uu, Ur, Ur, Uu, Uu, Qxu, Qxu, Qxu, Qxu, Qxu, Qxu, Qxu, Qxu, Qxu, Qxu, Qxu, Qxu, Qxu, Qxu
Xu, Qxu, Qxu, Qxu^Xo, Qxu^Xo, Qxu^Xo, Qxu^Xo, Qxu^Xo, Qxu^Xo, Qxu^Xo, Qxu^Xo, Qxu^Xo, Qxu^Xo, Qxu^Xo, Xu, Xu, Xu, Uu, Ur, Uu, Ur, Ur, Ur, Ur, Ur, Ur, Uu, Uu, Uu, Uu, Xu, Xu, Xu, Xu, Xu, Qxu, Qxu, Qxu, Qxu, Qxu, Qxu, Qxu, Qxu, Qxu
Xu, Xu, Xu, Qxu^Xo, Qxu^Xo, Qxu^Xo, Qxu^Xo, Qxu^Xo, Qxu^Xo, Qxu^Xo, Qxu^Xo, Qxu^Xo, Uh, Xu, Uh, Xu, Uu^Xo, Ur, Xu, Ur, Xu, Uu, Xu, Uu, Qxu, Qxu, Qxu, Uu, Qxu, Xu, Xu, Xu, Xu, Xu, Xu, Xu, Qxu, Qxu, Qxu, Qxu, Qxu, Qxu, Qxu, Qxu
Xu, Xu, Xu, Xu, Xu, Xu, Xu, Xu, Uh, Qxu^Xo, Uu, Uu, Uu, Uu, Ur, Ur, Xu, Xu, Xu, Xu, Xu, Xu, Xu, Qxu, Qxu, Qxu, Qxu, Qxu, Qxu, Qxu, Xu, Xu, Xu, Xu, Xu, Xu, Xu, Qxu, Qxu, Qxu, Qxu, Qxu, Qxu, Qxu
Xu, Xu, Xu, Xu, Xu, Xu, Uh, Uu^Uf, Uu^Edb, Uu, Uu, Uu, Uu, Ur, Uu, Xu, Xu, Xu, Xu, Xu, Xu, Xu, Xu, Xu, Xu, Qxu^Xo, Qxu^Xo, Qxu, Qxu, Qxu, Qxu, Qxu, Xu, Xu, Xu, Xu, Xu, Xu, Qxu, Qxu, Qxu, Qxu, Qxu, Qxu
Xu, Xu, Xu, Xu, Xu, Xu, Uu, Uu, Uu, Uu, Uu, Uu, Uu, Ur, Ur, Xu, Uh, Xu, Xu, Xu, Xu, Xu, Xu, Xu, Xu, Qxu, Qxu, Qxu^Xo, Qxu^Xo, Qxu^Xo, Qxu^Xo, Qxu^Xo, Qxu, Xu, Xu, Xu, Xu, Qxu, Qxu, Qxu, Qxu, Qxu, Qxu, Qxu
Xu, Xu, Xu, Xu, Uh, Uu^Uf, Uu, Uu, Uu, Uu, Uu, Uu, Uu, Uu, Uu^Edb, Ur, Ur^Dr, Xu, Xu, Xu, Xu, Xu, Xu, Xu, Uh, Uu^Uf, Uu, Qxu, Qxu, Qxu, Qxu, Qxu, Uh, Xu, Qxu, Qxu, Qxu, Qxu^Xo, Qxu^Xo, Qxu, Qxu, Qxu, Qxu, Xu
Xu, Xu, Xu, Xu, Uu^Edb, Uu^Edb, Uu^Edb, Uu, Uu, Uu, Uu, Uu, Uu, Uu, Uu^Uf, Uu^Dr, Xu, Xu, Ur^Dr, Xu, Xu, Xu, Uh, Uh, Uh, Uh, Ur, Ur, Ur, Ur, Ur, Qxu, Ur, Uh, Qxu, Qxu, Qxu, Qxu, Qxu^Xo, Qxu, Qxu, Qxu, Xu, Xu
Xu, Xu, Xu, Xu, Uu^Uf, Uu^Edb, Uu^Edb, Uu, Uu, Uu, Uu, Uu, Uu, Uu, Uh, Xu, Xu, Xu, Uu^Dr, Ur, Ur, Uh, Uu, Uh, Ur, Ur, Qxu, Qxu, Qxu, Uh, Xu, Ur, Uh, Ur, Ur, Uh, Uu, Xu, Xu, Xu, Xu, Xu, Xu, Xu
Xu, Xu, Xu, Uh, Uu^Edb, Uu^Edb, Uu, Uu, Xu, Uh, Xu, Uh, Xu, Xu, Xu, Xu, Xu, Uu, Uh, Uu, Uh, Ur, Ur, Ur, Xu, Qxu, Qxu^Xo, Qxu^Xo, Qxu^Xo, Xu, Xu, Xu, Xu, Uu, Uu, Ur, Ur^Dr, Uu^Vu, Xu, Xu, Xu, Xu, Xu, Xu
Xu, Xu, Xu, Uh, Uh, Uu^Edb, Qxu, Qxu, Qxu^Xo, Xu, Xu, Xu, Xu, Xu, Xu, Xu, Xu, Uu^Uf, Xu, Uh, Xu, Uh, Xu, Xu, Xu, Qxu^Xo, Qxu^Xo, Qxu^Xo, Qxu^Xo, Qxu^Xo, Qxu^Xo, Xu, Xu, Xu, Xu, Uu^Dr, Xu, Uu^Dr, Xu, Xu, Xu, Xu, Xu, Xu
Xu, Xu, Xu, Xu, Xu, Qxu, Qxu^Xo, Qxu^Xo, Qxu^Xo, Xu, Xu, Xu, Xu, Xu, Xu, Xu, Xu, Xu, Xu, Xu, Xu, Xu, Qxu^Xo, Qxu^Xo, Qxu^Xo, Qxu^Xo, Qxu^Xo, Qxu^Xo, Xu, Qxu^Xo, Xu, Xu, Xu, Xu, Xu, Xu, Ur^Dr, Xu, Xu, Xu, Xu, Xu, Xu, Xu
Xu, Xu, Xu, Xu, Xu, Qxu^Xo, Qxu^Xo, Qxu^Xo, Qxu^Xo, Xu, Xu, Xu, Xu, Xu, Xu, Xu, Cud, Xu, Xu, Xu, Xu, Qxu^Xo, Qxu^Xo, Qxu^Xo, Qxu^Xo, Qxu^Xo, Qxu^Xo, Qxu^Xo, Xu, Xu, Xu, Xu, Xu, Xu, Ur, Uu^Dr, Ur, Uu^Dr, Uu^Vu, Xu, Cud, Cud, Cud, Xu
Xu, Xu, Xu, Xu, Qxu^Xo, Qxu^Xo, Qxu^Xo, Qxu^Xo, Qxu, Xu, Xu, Xu, Xu, Xu, Cud, Cud, Xu, Cud, Xu, Xu, Xu, Xu, Qxu^Xo, Qxu^Xo, Qxu^Xo, Qxu^Xo, Xu, Xu, Xu, Xu, Ur, Uu^Uf, Ur, Ur, Ur, Ur, Ur, Ur, Ur, Ur, Cud, Kud, Cud, Xu
Xu, Xu, Xu, Xu, Qxu^Xo, Qxu^Xo, Qxu, Qxu, Uu, Xu, Uu, Uu^Uf, Ur, Cud, Ur, Kud, Ur, Ur, Ur, Xu, Xu, Xu, Qxu^Xo, Qxu^Xo, Qxu^Xo, Qxu^Xo, Qxu, Xu, Uh, Uh, Ur, Ur, Ur, Ur, Uh, Ur, Uh, Uh, Xu, Ur, Xu, Cud, Xu, Xu
Xu, Xu, Xu, Xu, Qxu^Xo, Qxu, Uh, Uu, Uu, Uu, Uu, Uu, Ur, Ur, Ur, Ur, Ur, Ur, Ur, Uh, Xu, Xu, Qxu, Qxu^Xo, Qxu^Xo, Qxu^Xo, Qxu, Uh, Ur, Ur, Ur, Ur, Xu, Uu^Vu, Uh, Uh, Uh, Uh, Xu, Xu, Xu, Xu, Xu, Xu
Xu, Xu, Xu, Xu, Xu, Qxu, Uu, Uu, Uu, Uu, Uu, Uu, Xu, Cud, Cud, Kud, Xu, Ur, Ur, Ur, Ur, Qxu, Uu^Vu, Qxu, Qxu, Qxu, Ur, Ur, Ur, Ur, Xu, Xu, Xu, Xu, Xu, Xu, Xu, Xu, Xu, Xu, Xu, Xu, Xu, Xu
Xu, Xu, Xu, Xu, Xu, Qxu, Uu, Uu, Xu, Xu, Xu, Xu, Xu, Xu, Xu, Cud, Cud, Cud, Ur, Ur, Ur, Ur, Ur, Ur, Ur, Ur, Ur, Ur, Uh, Uh, Xu, Xu, Xu, Xu, Xu, Xu, Xu, Xu, Xu, Xu, Xu, Xu, Xu, Xu
Xu, Xu, Xu, Xu, Xu, Xu, Uu, Uu, Xu, Xu, Xu, Xu, Xu, Xu, Xu, Xu, Xu, Xu, Xu, Uh, Uh, Ur, Ur, Ur, Uh, Ur, Uu^Vu, Ur, Xu, Xu, Xu, Xu, Xu, Xu, Xu, Xu, Xu, Xu, Xu, Xu, Xu, Xu, Xu, Xu
Xu, Xu, Xu, Xu, Uu, 1 Uu, 2 Uu, Uu, Xu, Xu, Xu, Xu, Xu, Xu, Xu, Xu, Xu, Xu, Xu, Xu, Xu, Xu, Xu, Xu, Xu, Uh, Xu, Xu, Xu, Xu, Xu, Xu, Xu, Xu, Xu, Xu, Xu, Xu, Xu, Xu, Xu, Xu, Xu, Xu
Xu, Xu, Xu, Uu, Uu, Uu, Xu, Xu, Xu, Xu, Xu, Xu, Xu, Xu, Xu, Xu, Xu, Xu, Xu, Xu, Xu, Xu, Xu, Xu, Xu, Xu, Xu, Xu, Xu, Xu, Xu, Xu, Xu, Xu, Xu, Xu, Xu, Xu, Xu, Xu, Xu, Xu, Xu, Xu
