Ms^Xm, Ms^Xm, Ms^Xm, Ms^Xm, Ms, Ms^Xm, Ai, Ai, Ai, Ai, Ai, Ai, Ai, Ai, Ai, Ai, Ai, Ms^Xm, Aa, Ms^Xm, Aa, Ms^Xm, Ms, Ms, Ms^Xm, Ms^Xm, Aa, Aa, Aa^Es, Ms^Xm, Ms^Xm, Ms^Xm, Ms^Xm, Ms^Xm, Ms^Xm, Ms^Xm, Ms^Xm, Ms^Xm, Koa, Koa, Ko, Koa, Koa, Ms^Xm, Ms^Xm
Ms^Xm, Ms^Xm, Ms^Xm, Ms^Xm, Ms, Ms, Ai, Ai, Ai, Ai, Ai, Ai, Ai, Ai, Ai, Ai, Rd, Aa, Aa, Aa, Aa, Aa, Aa, Ms, Ai, Ms^Xm, Ai, Aa, Aa, Aa, Aa, Ms^Xm, Ai, Ms^Xm, Ai, Ms^Xm, Aa, Koa^Ebn, Re^Vct, Coa, Ko, Coa, Re^Vct, Koa^Ebn, Ms^Xm
Ms^Xm, Ms^Xm, Ms^Xm, Ms, Ai, Ai, Ai, Ai, Ai, Ai, Ai, Ai, Aa, Ai, Aa, Aa, Rd, Aa, Aa, Aa, Koa, Aa, Aa, Ai, Ai, Ai, Ai, Aa, Aa, Aa, Ai, Aa, Ai, Ai, Ai, Ai, Ai, Koa, Coa, Re^Vct, Koa, Re^Vct, Coa, Koa, Ms^Xm
Ms^Xm, Ms^Xm, Ha, Ai, Ai, Ai, Ai, Ai, Ai, Ai, Ai, Ai, Aa, Aa, Aa^Fpa, Aa^Fpa, Rd, Aa^Vaa, Rd, Aa, Rd, Aa, Aa, Ai, Ai, Ai, Ai, Ai, Ai, Ai, Ai, Ai, Ai, Ai, Ai, Ai, Ai, Koa^Ebn, Ko, Ko, Re^Vct, Ko, Ko, Koa^Ebn, Ms
Ms^Xm, Ha, Ms, Ai, Ai, Ai, Ai, Ai, Ai, Ai, Aa^Es, Aa, Aa^Fpa, Aa^Fpa, Aa^Fpa, Aa^Fpa, Aa^Fpa, Rd, Rd, Rd, Aa, Rd, Rd, Aa, Ai, Ai, Ai, Ai, Ai, Ai, Ai, Ai, Ai, Ai, Rd^Ecf, Aa, Rd, Koa, Koa^Ebn, Coa, Re^Vct, Coa, Koa^Ebn, Koa, Ms
Ms^Xm, Ms, Ms^Xm, Ai, Ai, Ai, Ai, Ai, Ai, Ai, Aa, Aa, Aa, Aa^Fpa, Aa^Fpa, Aa^Fpa, Aa^Fpa, Rd, Aa, Aa, Aa, Aa, Rd, Rd, Rd, Ai, Rd, Ai, Ai, Ai, Aa, Aa, Rd, Rd, Rd, Rd, Rd, Rd, Ha, Koa, Koa^Ebn, Koa, Ms, Ms^Xm, Ms^Xm
Ms^Xm, Ms, Ms, Ha, Ai, Ai, Ai, Ai, Ai, Aa, Aa, Aa, Aa, Aa^Fpa, Rd, Rd, Rd, Rd, Aa, Aa, Aa, Aa, Aa, Rd, Rd, Rd, Ai, Ai^Bw\, Ai^Bw\, Aa, Aa, Rd, Rd, Rd, Rd, Rd, Rd^Ecf, Aa^Fda, Aa^Fda, Ha, Ha, Ms, Ms, Ms^Xm, Rd
Aa, Ms^Xm, Ms, Ha, Ha, Ai, Ai, Ai, Aa^Fda, Aa, Aa, Aa^Vaa, Rd, Rd, Aa, Aa, Aa, Aa, Aa^Fda, Aa^Fda, Aa^Fda, Aa, Aa, Aa, Aa, Aa, Ai, Ai, Ai, Ai^Bw\, Rd, Rd, Rd, Rd, Aa, Rd, Ai, Aa^Fda, Aa^Fda, Aa^Fda, Ms^Xm, Ha, Ha, Rd, Ms^Xm
Aa, Ms^Xm, Ms, Ms, Ai, Ai, Ai, Aa^Fda, Aa^Fda, Aa^Fda, Aa^Fda, Aa, Rd, Aa, Aa, Aa, Aa^Fpa, Aa^Fpa, Aa^Fda, Aa^Fda, Aa^Fda, Aa^Fda, Ms, Aa, Ms^Xo, Aa, Ai, Ai, Ai, Aa, Rd, Aa, Aa, Aa, Aa, Ai, Ai, Ai, Aa, Aa^Fda, Aa^Fda, Koa, Rd, Rd, Ms
Aa, Ms^Xm, Ms, Ms, Ha, Ai, Ai, Aa^Fda, Aa^Fda, Aa^Fda, Aa^Fda, Aa^Fda, Rd, Aa, Aa, Aa, Aa^Fda, Aa^Fda, Aa^Fda, Aa^Fda, Ms, Ms, Ms^Xm, Ms^Xo, Ms^Xo, Ms^Xm, Ai, Ai, Ai, Aa, Rd, Aa, Aa, Aa^Es, Aa, Ai, Ai, Ai, Ai, Ms^Xm, Rd, Rd, Ha, Ms, Ha
Aa, Ms, Ms^Xm, Ms, Ha, Ai, Ai, Aa^Fda, Aa^Fda, Aa^Fda, Aa^Fda, Aa^Fda, Aa, Rd, Aa, Aa, Aa^Fda, Aa^Fda, Aa^Fda, Ms, Ms, Ms^Xm, Ms^Xm, Ms^Xo, Ms^Xo, Ms^Xm, Ha, Ai, Ai, Koa, Aa, Rd, Rd, Aa, Aa, Aa, Ai, Ai, Ai^Bw/r, Rd, Rd, Aa^Fda, Aa^Fda, Ha, Aa^Fda
Ms^Xm, Ms^Xm, Ms^Xm, Ms^Xm, Ai, Ai, Ha, Aa^Fda, Ha^Vhha, Aa^Fda, Rd, Aa, Rd, Rd, Aa, Aa, Aa, Aa^Fda, Aa^Fda, Ms, Ms, Ms^Xm, Ms^Xm, Ms^Xo, Ms^Xo, Ms^Xm, Ha, Ai, Ai, Ai, Aa^Fpa, Aa, Aa, Rd, Rd, Rd, Rd, Ai^Bw/r, Ai, Ai, Ai, Aa, Aa, Aa^Fda, Aa
Ai, Ms^Xm, Ms^Xm, Ms^Xm, Ai, Ha, Ms, Ha, Ha, Rd, Aa, Rd, Aa^Fda, Rd, Aa, Aa, Aa^Fda, Aa^Fda, Aa^Fda, Aa^Fpa, Rrc^Vhca, Ms, Ms^Xm, Ms^Xo, Ms^Xo, Ms, Ms, Ai, Ai, Ai, Aa^Fpa, Aa^Fpa, Aa^Fpa, Aa, Aa, Rd, Aa, Aa, Aa, Ai, Ai, Ai, Ai, Aa, Aa
Ai, Ai, Ai, Ai, Ai, Ms^Xm, Ha, Ha, Ha, Ha, Aa, Aa^Fda, Aa^Fda, Rd, Aa, Aa^Fda, Aa^Fda, Aa^Fda, Aa^Fda, Aa^Fpa, Ai, Ai, Ms, Ms^Xm, Ms^Xm, Ms^Xo, Ms, Ha, Ai, Ai, Aa^Fpa, Aa^Fpa, Aa^Fpa, Aa, Aa, Rd, Aa, Aa, Aa^Fpa, Aa^Fpa, Aa^Fpa, Ai, Ai, Ai, Ai
Ha, Ai, Ha, Ha, Ha, Ms, Ms, Ha, Ha, Ha, Aa^Fda, Aa^Fda, Aa, Rd, Aa, Aa^Fda, Aa^Fda, Aa^Fda, Ai, Ai, Ai, Ai, Coa, Ko, Coa, Ms^Xo, Ms^Xo, Ha, Ha, Ai, Ai, Aa^Fpa, Aa^Fpa, Aa^Fpa, Aa^Fpa, Rd, Rd, Aa^Es, Aa, Aa^Fpa, Aa^Fpa, Ai, Ai, Ai, Ai
Ms, Ms, Ms^Xm, Ms, Ms, Ms, Ms^Xm, Ms, Ms, Aa^Fda, Aa^Fda, Aa, Aa, Rd, Aa, Aa^Fda, Aa^Fda, Aa^Fda, Aa^Fda, Ai, Ai, Ko, Coa, Coa, Coa, Ko, Ms^Xm, Ms^Xo, Ms^Xm, Ai, Ai, Ai, Aa^Fda, Aa^Fpa, Aa^Fpa, Aa, Aa, Rd, Rd, Aa^Fpa, Aa^Fpa, Aa^Fpa, Aa^Fpa, Ai, Ai
Ha, Ms^Xm, Ms^Xm, Ms^Xm, Ms^Xm, Ms^Xm, Ms^Xm, Ms^Xm, Ms, Ms, Ha, Aa^Fda, Aa, Rd, Aa, Aa, Aa^Fda, Aa^Fda, Aa^Fda, Ai, Ai, Coa, Coa, Koa, Coa, Coa, Ms^Xm, Ms^Xo, Ms^Xo, Ai, Ai, Ai, Ha, Aa^Fpa, Aa^Fda, Aa, Aa^Fda, Aa, Rd, Aa, Aa, Aa^Fpa, Aa^Fpa, Aa^Fpa, Aa^Fpa
Aa^Fpa, Ms^Xm, Ms^Xm, Ms, Cea, Ms, Ms, Ms, Ms, Ms^Xm, Ms^Xm, Ms^Xm, Aa, Rd, Rd, Aa, Aa, Aa^Fda, Aa^Es, Ai, Ai, Ko, Coa, Coa, Coa, Ko, Ms, Ms^Xo, Ms^Xo, Ms^Xm, Ms, Ai, Ai, Aa^Fda, Aa, Aa^Fda, Aa^Fda, Aa^Fda, Rd, Aa, Aa, Aa^Fpa, Aa^Fpa, Aa^Fpa, Aa^Fda
Aa, Ms, Ha, Cea, Kea, Cea, Re^Vct, Ha^Vhha, Rd, Ms, Aa^Fda, Aa^Fda, Aa, Aa, Rd, Aa, Aa, Aa, Aa, Ai, Aa, Aa, Aa, Ko, Ai, Rrc^Vhca, Ms, Ms^Xm, Ms^Xo, Ms^Xm, Ms^Xm, Ms, Ai, Ai, Ai, Aa^Fda, Aa^Fda, Aa, Aa, Rd, Rd, Aa, Aa, Aa^Fpa, Aa^Fda
Ms, Ms, Re^Vct, Cea, Cea, Cea, Cea, Aa^Fda, Aa^Fda, Rd, Rd, Aa^Fda, Aa, Aa, Rd, Aa, Aa, Aa, Aa, Aa, Aa, Aa, Aa, Ai, Ai, Ai, Ms, Ms, Ms^Xm, Ms^Xo, Ms^Xo, Ms^Xm, Ms^Xm, Ms, Ms, Ai, Ai, Aa, Aa^Fda, Aa, Rd, Aa, Aa, Aa^Fda, Aa^Fda
Ms, Ha, Ms, Cea, Cea, Kea, Cea, Aa^Fda, Ai, Aa, Rd, Rd, Rd, Rd, Aa, Rd, Rd, Aa, Rd, Aa, Rd, Aa, Rd, Aa, Aa, Ai, Ms, Ms^Xm, Ms^Xm, Ms^Xm, Ms, Ms^Xo, Ms^Xo, Ms^Xm, Ms^Xm, Ai, Ai, Aa^Fda, Aa^Fda, Aa, Rd, Aa^Es, Aa, Aa^Fda, Aa^Fda
Ms, Ha, Ai, Cea, Kea, Cea, Re^Vct, Ai, Ai, Ai, Aa, Aa, Ha^Vhha, Aa, Aa, Aa, Aa, Rd, Aa, Rd, Aa, Rd, Rd, Rd, Rd, Ai, Ms, Ms, Ms, Ms, Ms^Xm, Ms, Ms^Xm, Ms^Xo, Ms, Ms, Ai, Ai, Ai, Aa^Fda, Aa, Rd, Rd, Aa, Aa^Fda
Ms, Ha, Ai, Cea, Cea, Cea, Ai, Ai, Aa^Fpa, Aa^Fpa, Aa^Fma, Ha, Ms, Ha, Ha, Aa, Aa^Fpa, Aa, Aa^Fpa, Aa, Aa^Fpa, Aa, Aa^Fpa, Aa^Fpa, Aa^Fpa, Rd, Aa^Fpa, Aa^Fpa, Aa^Fpa, Aa^Fpa, Rd, Aa, Ms^Xm, Ms^Xo, Ms^Xm, Ms, Ai, Ai, Ai, Aa^Fda, Aa^Fda, Aa^Fda, Rd, Aa, Aa^Fda
Ms, Ms^Xm, Ha, Ai, Ai, Ai, Ai, Ai, Ai, Aa^Fma, Aa^Fma, Ha, Ms, Ms, Aa^Fpa, Aa^Fpa, Aa^Fpa, Aa^Fpa, Aa^Fpa, Aa^Fpa, Aa^Fpa, Aa^Fpa, Aa^Fma, Aa^Fpa, Rd, Rd, Rd, Aa^Fpa, Rd, Rd, Ms, Aa^Fpa, Ms, Ms^Xo, Ms^Xm, Ms^Xm, Ai, Ai, Aa^Fda, Aa^Fda, Aa^Fda, Aa^Fda, Rd, Aa^Fda, Aa
Ms, Ms^Xm, Ms^Xm, Ha, Ha, Ai, Aa^Fpa, Aa^Fpa, Ha, Ha, Ms^Xm, Ms^Xm, Ms^Xm, Ms, Ms^Xm, Aa^Fma, Aa^Fma, Aa^Fma, Aa^Fma, Aa^Fma, Aa^Fma, Aa^Fma, Rd, Rd, Aa^Fpa, Aa^Fpa, Aa^Fpa, Rd, Aa^Fpa, Aa^Fpa, Ms, Ms, Ms^Xm, Ms^Xo, Ms^Xm, Ms^Xm, Ai, Ai, Aa^Fpa, Aa^Fda, Aa^Fpa, Aa^Fpa, Rd, Aa^Fpa, Aa^Fpa
Aa, Ms^Xm, Ms^Xm, Ms^Xm, Ai, Ai, Ha, Ha, Ms^Xm, Ms, Ms^Xm, Ms^Xm, Ms^Xm, Ms^Xm, Ms^Xm, Ms^Xm, Ms^Xm, Cvr, Cvr, Cvr, Cvr, Kvr, Rd, Kvr, Cvr, Cvr, Cvr, Cvr, Ms, Ms^Xm, Ms^Xm, Ms^Xm, Ms^Xo, Ms^Xo, Ms^Xm, Ai, Ai, Ai, Aa^Fpa, Aa^Fpa, Aa^Fpa, Rd, Aa^Fpa, Aa^Fpa, Aa^Fpa
Aa^Fma, Ms^Xm, Ms^Xm, Ms^Xm, Ai, Ha, Ms^Xm, Ms^Xm, Ms^Xm, Ms^Xm, Ms^Xm, Ms^Xm, Ai, Ms^Xm, Ai, Ai, Ai, Ha, Aa^Fma, Aa^Fma, Aa, Rd, Aa, Rd, Aa^Fma, Aa^Es, Aa^Fma, Aa^Fma, Ms, Ms^Xm, Ms^Xm, Ms^Xm, Ms^Xo, Ms, Ms, Ai, Ai, Ai, Aa^Fma, Aa^Fma, Rd, Rd, Aa^Fma, Aa^Fma, Aa^Fma
Ms^Xm, Ms^Xm, Ms^Xm, Ms^Xm, Ai, Ms^Xm, Ms^Xm, Ms^Xm, Ms^Xm, Ms^Xm, Ms, Ha, Ai, Ai, Ai, Ai, Aa^Fma, Aa^Fma, Aa^Eb, Aa^Vea, Rd, Rd, Aa, Rd, Aa^Dr, Aa^Fma, Aa^Fma, Aa^Fma, Ms^Xm, Ms, Ms^Xm, Ms^Xm, Ms^Xo, Ms, Ms, Ai, Ai, Ai, Aa^Fma, Aa^Fma, Rd, Aa^Fma, Rd, Aa^Fma, Rd
Ms, Ms^Xm, Ms^Xm, Ms^Xm, Ai, Ms^Xm, Ms, Ms, Ha, Ha, Aa^Fma, Aa^Fma, Ai, Ai, Ai, Ai, Aa^Fma, Aa^Fma, Aa, Rd, Aa, Aa, Aa, Aa^Fma, Aa^Fma, Aa^Fma, Aa^Fma, Aa^Fma, Aa^Fma, Ms, Ms^Xm, Ms^Xo, Ms^Xm, Ms^Xm, Ai, Ai, Aa^Fma, Ai, Ai, Rd, Rd, Rd, Rd, Rd, Rd
Ha, Ms^Xm, Ms, Ai, Ai, Ms, Ai, Ms, Ha, Ha, Ai, Ai, Ai, Ai, Aa^Fma, Aa^Dr, Rd, Aa^Fma, Aa, Rd, Aa, Aa, Aa^Fma, Aa^Fma, Aa^Fma, Aa^Fma, Aa^Fma, Aa^Fma, Ha, Ms, Ms^Xo, Ms^Xo, Ms^Xm, Ms^Xm, Ai, Ai, Ms, Rd, Ai^Bw/, Rd, Aa^Fma, Rd, Aa^Fma, Rd, Aa^Fma
Aa^Fma, Ms, Ai, Ai, Ha, Ai, Ha, Ai, Ai, Ai, Ai, Ai, Aa^Fma, Aa^Fma, Aa^Fma, Aa^Fma, Rd, Aa, Aa, Rd, Aa^Eb, Aa^Fma, Aa^Fma, Aa^Fma, Ha, Ha, Ai, Ha, Ai, Ms^Xo, Ms^Xo, Ms^Xm, Ha, Ai, Ha^Vhha, Ms, Aa^Fma, Rd, Ai, Aa^Fma, Aa^Fma, Aa^Fma, Aa^Fma, Aa^Fma, Aa^Fma
Aa^Fma, Ai, Ai, Ha, Aa^Fma, Ha, Aa^Fma, Aa^Fma, Aa^Fma, Aa^Fma, Aa^Vea, Aa^Eb, Aa, Aa, Aa, Aa, Aa, Rd, Rd, Rd, Aa^Vea, Aa^Fma, Aa^Fma, Aa^Fma, Ai, Ai, Ai, Ai, Ms^Xo, Ms^Xo, Ms, Ha, Ha, Ha, Rd, Aa^Fma, Aa^Fma, Rd, Rd, Ai, Aa^Fma, Aa^Fma, Aa^Fma, Aa^Fma, Aa^Fma
Aa^Fma, Ai, Aa^Fma, Aa^Dr, Rd, Aa^Fma, Aa^Fma, Aa^Fma, Aa^Fma, Aa^Fma, Aa^Dr, Rd, Rd, Aa, Aa, Aa^Dr, Rd, Rd, Aa^Fma, Aa^Fma, Aa^Fma, Aa^Fma, Ai, Ai, Ms^Xm, Ms, Ms, Ms^Xo, Ms^Xm, Ms, Ha^Vhha, Aa, Aa^Fma, Aa^Fma, Rd, Aa^Fma, Rd, Rd, Rd, Ai, Ai, Aa^Fma, Aa^Fma, Aa^Fma, Ms
Ai, Ai, Aa^Fma, Aa^Fma, Rd, Aa^Fma, Aa^Fma, Aa^Fma, Aa^Fma, Aa^Fma, Ha, Aa^Fma, Ha, Rd, Rd, Rd, Aa^Fma, Aa^Es, Aa^Fma, Aa^Fma, Aa^Fma, Ha, Ai, Ai, Ms^Xm, Ms^Xm, Ms^Xo, Ms^Xo, Ms^Xm, Ha, Ha, Re, Re, Aa^Fma, Rd, Rd, Rd, Rd, Aa^Fpa, Aa^Fpa, Ai, Ms, Ms, Ms, Ms
Ms, Ai, Ai, Aa^Fma, Aa^Fma, Rd, Rd, Aa^Fma, Ha, Ha, Aa, Ha, Aa, Rd, Ha, Ha, Ha, Ha, Ha, Aa^Fma, Ai, Ai, Ms^Xm, Ms^Xm, Ms^Xm, Ms^Xm, Ms^Xo, Ms, Ha, Aa^Fpa, Aa^Fpa, Aa^Fpa, Aa^Fpa, Rd, Rd, Rd, Aa^Fpa, Aa^Fpa, Aa^Fpa, Aa^Fpa, Aa, Ai, Ms, Ms, Ms
Ms, Ms, Ms, Aa^Fma, Aa^Es, Aa^Fma, Rd, Rd, Rd, Rd, Rd, Rd, Rd, Rd, Ms, Ms, Ms, Ms, Ms, Ha, Ms, Ai, Ms^Xm, Ms^Xm, Ms^Xm, Ms^Xo, Ms^Xo, Ms, Ha, Aa^Fpa, Aa^Fpa, Aa^Fpa, Aa^Fpa, Aa, Aa, Rd, Aa^Fpa, Aa^Fpa, Aa^Fpa, Aa^Fpa, Aa^Es, Ai, Ai, Ms, Ms
Ms^Xm, Ms, Ms, Ms, Ha, Rd, Ms, Ms, Ms, Ha, Ha, Ha, Ha, Rd, Rd, Ms, Ms, Ms, Ms, Ms, Ms, Ms, Ms, Ha, Ms^Xm, Ms^Xo, Ms^Xm, Ms, Ha, Ha, Aa^Fpa, Aa^Fpa, Aa^Fpa, Aa^Fpa, Aa, Rd, Aa, Aa^Fpa, Aa^Fpa, Aa^Fpa, Aa, Ai, Ms, Ms, Ms
Ms^Xm, Ha, Ms, Ms, Ms, Rd, Ha, Ms, Ms^Xm, Ms, Ms^Xm, Ai, Ai, Aa^Fma, Rd, Ms, Ms, Ms, Aa^Fma, Ms, Aa^Fma, Ms, Ha, Ms, Ms, Ms^Xo, Ms^Xm, Ms^Xm, Ms^Xm, Ha, Ha, Aa^Fpa, Aa^Fpa, Aa, Rd, Rd, Rd, Aa, Aa, Aa^Fpa, Aa, Ai, Ai, Ms, Ms
Ms^Xm, Rd, Rd, Ms, Ms, Rd, Rd, Ha, Ms^Xm, Ms^Xm, Ms, Ai, Aa^Fma, Aa^Fma, Rd, Rd, Rd, Rd, Rd, Aa^Fma, Rd, Aa^Fma, Aa^Fma, Ha, Ms, Ms^Xo, Ms^Xo, Ms, Ms^Xm, Aa^Fma, Ha, Aa^Fpa, Re, Rd, Aa^Fpa, Aa, Aa, Rd, Aa, Aa^Fpa, Aa^Fpa, Ms, Aa^Fma, Ai, Ai
Ms^Xm, Ms^Xm, Rd, Ha, Ha, Ha, Rd, Ha, Ha, Ms, Ms, Ms, Rd, Aa^Fma, Rd, Koa, Coa, Aa^Fma, Aa^Fma, Rd, Aa^Fma, Rd, Rd, Ha, Ms, Ms^Xm, Ms^Xo, Ms^Xm, Ms^Xm, Ms, Aa^Fma, Ha^Vhha, Aa, Aa^Fma, Aa^Fpa, Aa^Fpa, Aa, Rd, Aa, Aa^Fpa, Aa^Fma, Aa^Fma, Aa^Fma, Aa^Fma, Ai
Ms^Xm, Ms^Xm, Ms^Xm, Rd, Rd, Rd, Koa, Rd, Rd, Ha, 2 Rd, 1 Rd, Aa^Fma, Rd, Aa^Fma, Ms, Ms, Ms, Ms^Xm, Aa^Fma, Ms^Xm, Aa^Fma, Ms^Xm, Aa^Fma, Ms, Ms^Xm, Ms^Xo, Ms^Xo, Ms, Ms, Ms, Ha, Ha, Aa^Fma, Aa^Fma, Aa^Fpa, Rd, Rd, Aa, Aa, Aa^Fma, Aa^Fma, Aa^Fma, Aa^Fma, Aa^Fma
Ms^Xm, Ms^Xm, Ms^Xm, Ha, Ha, Coa, Ha, Ms^Xm, Ms^Xm, Rd, Ha, Aa^Fma, Ms, Aa^Fma, Ha, Ha, Ms, Ms^Xm, Ms, Ms, Ms, Ms^Xm, Ms^Xm, Ms^Xm, Ms, Ms^Xm, Ms^Xm, Ms^Xo, Ms^Xm, Ms, Ms, Ha, Ha, Aa, Re, Rd, Aa^Fpa, Rd, Rd, Aa, Aa^Fma, Aa^Fma, Aa^Fma, Aa^Fma, Ha
Ms^Xm, Ms^Xm, Ms^Xm, Ms, Ms, Ms, Ms, Ms^Xm, Ms^Xm, Ms^Xm, Ms^Xm, Ms, Ms^Xm, Ms, Ms^Xm, Ms^Xm, Ms^Xm, Ms^Xm, Ms, Ms, Ms, Ms, Ms, Ms^Xm, Ms, Ms^Xm, Ms, Ms^Xo, Ms^Xo, Ms^Xm, Ms^Xm, Ha, Ha, Ha^Vhha, Re, Aa^Fma, Ha, Aa^Fma, Aa^Fpa, Rd, Aa, Aa^Fma, Aa^Fma, Ha, Ms
Ms^Xm, Ms^Xm, Ms^Xm, Ms, Ms, Ms, Ms^Xm, Ms^Xm, Ms^Xm, Ms^Xm, Ms^Xm, Ms^Xm, Ms^Xm, Ms^Xm, Ms^Xm, Ms^Xm, Ms^Xm, Ms^Xm, Ms, Ms, Ms, Ha, Ms, Ms, Ms, Ms^Xm, Ms, Ms^Xm, Ms, Ms^Xo, Ms^Xo, Ms^Xm, Ms, Ha, Ha, Ha, Aa^Fma, Aa^Fma, Aa^Fma, Rd, Rd, Aa^Fma, Aa^Fma, Ha, Ms
