Aa^Fpa, Ms^Xm, Aa^Fpa, Ms^Xm, Aa^Fpa, Ms^Xm, Aa^Fpa, Aa^Fpa, Aa^Fpa, Aa^Fpa, Aa^Fpa, Aa^Fpa, Ha, Aa^Fpa, Ha, Ha, Ha, Aa^Fpa, Ms^Xm, Ms^Xm, Ms^Xm, Ms^Xm, Ms^Xm, Ms^Xm, Ms^Xm, Ms^Xm, Ms^Xm, Ms^Xm, Ms^Xm, Ms^Xm, Ms^Xm, Ms^Xm, Ms^Xm, Ms^Xm, Ms^Xm, Ms^Xm, Ms^Xm, Ms^Xm, Ms^Xm, Ms^Xm, Ms^Xm, Ms^Xm, Ms^Xm, Ms^Xm, Ms^Xm, Ms^Xm
Aa^Fpa, Aa^Fpa, Aa^Fpa, Aa^Fpa, Aa^Fpa, Aa^Fpa, Aa^Vea, Aa^Fpa, Aa^Fpa, Aa^Fpa, Aa^Fpa, Ha, Ha, Ha, Ms^Xm, Ha, Ms^Xm, Ms^Xm, Ms^Xm, Ms^Xm, Ms^Xm, Ms^Xm, Ms^Xm, Ms^Xm, Ms^Xm, Ms^Xm, Ms^Xm, Ms^Xm, Ms^Xm, Ms^Xm, Ms^Xm, Ms^Xm, Ms, Ms, Ms, Ms^Xm, Ms, Ms^Xm, Ms, Ms^Xm, Ms^Xm, Ms^Xm, Ms^Xm, Ms^Xm, Ms^Xm, Ms^Xm
Aa^Fpa, Aa^Fpa, Aa^Fpa, Aa^Fpa, Aa^Fpa, Aa^Fpa, Aa^Fpa, Aa^Fpa, Aa^Fpa, Aa^Fpa, Aa^Fpa, Ha, Ms^Xm, Ms^Xm, Ms^Xm, Ms^Xm, Ms^Xm, Ms^Xm, Ms^Xm, Ms^Xm, Ms^Xm, Ms^Xm, Ms, Ms^Xm, Ms^Xm, Ms^Xm, Ms, Ms, Ms, Ms, Ms, Ms, Ms, Ms, Ms^Xm, Ms, Ms, Ms, Ms, Ms, Ms, Ms^Xm, Ms, Ms^Xm, Ms, Ms
Aa^Fpa, Aa^Fpa, Aa^Fpa, Aa^Fpa, Aa^Fpa, Aa^Fpa, Aa, Aa, Aa^Fpa, Aa^Fpa, Aa^Fpa, Ha, Ms^Xm, Ms^Xm, Ms^Xm, Ms^Xm, Ms, Ms, Ms, Ms, Ms^Xm, Ms^Xm, Ms, Ms^Xm, Ms^Xm, Ms^Xm, Ms, Ms, Ms^Xm, Ms, Ms, Ms, Ms^Xm, Ms^Xm, Ms^Xm, Ms^Xm, Ms, Ms, Ms, Ms, Ms, Ms, Ms, Ms, Ms, Ms
Aa, Aa^Fpa, Aa^Fpa, Aa^Fpa, Aa^Fpa, Aa^Fpa, Aa, Aa^Fpa, Aa^Fpa, Aa^Fpa, Aa^Fpa, Ha, Ha, Ms^Xm, Ms, Ms, Ms, Ms, Ms, Ms^Xm, Ms^Xm, Ms, Ms, Ms^Xm, Ms, Ms^Xm, Ms, Ms, Ms^Xm, Ms, Ms, Ms, Ms^Xm, Ms, Ms^Xm, Ms^Xm, Ms, Ms^Xm, Ms^Xm, Ms^Xm, Ms, Ms, Ms, Ms, Ms, Ms
Aa, Aa, Re^Vct, Aa, Aa, Aa, Aa, Aa^Es, Aa^Fpa, Aa^Fpa, Aa^Fpa, Aa^Fpa, Ha, Ms, Ms, Ms, Ha, Ha, Ha, Ha^Vhha, Ha, Ms, Ai, Ms^Xm, Ms, Ms, Ms^Xm, Ms, Ms^Xm, Ms^Xm, Ms^Xm, Ms, Ms, Ms, Ms, Cud, Ms^Xm, Ms^Xm, Ms^Xm, Cud, Ms, Ms, Ms, Ms, Ms, Ms
Aa, Ce, Ce, Ce, Re^Vct, Aa, Aa, Aa^Fpa, Aa^Fpa, Aa^Fpa, Aa^Fpa, Aa^Fpa, Ha, Ha, Ha, Ha, Ai, Ai, Ai, Ai, Ai, Ai, Ai, Ms, Ms^Xm, Ms^Xm, Ms, Ms^Xm, Ms^Xm, Ms^Xm, Ms, Ms, Ms, Ms^Xm, Ms^Xm, Cud, Urb, Urb, Urb, Cud, Ms^Xm, Ms, Ms, Ms, Ms, Ms
Rd, Ce, 1 Kea, Ce, Rd, Aa, Aa, Aa, Aa, Aa, Aa, Aa^Fpa, Aa^Fpa, Ha, Aa^Fpa, Ai, Aa^Fpa, Ai, Ai, Ai, Ai, Ai, Ha, Ha, Ms, Ms, Ms^Xm, Ms^Xm, Ms^Xm, Ms^Xm, Ms, Ms, Ms^Xm, Ms^Xm, Ms^Xm, Cud, Cud, Urb, Cud, Cud, Ms, Ms, Ms, Ms, Ms, Ms
Aa, Rd, Rd, Rd, Aa, Rd, Rd, Aa, Aa, Aa, Rd, Aa, Aa, Aa^Fpa, Aa^Fpa, Aa^Fpa, Aa, Aa, Aa^Fpa, Ai, Aa^Fpa, Ai, Ha, Ha, Ms, Ms^Xm, Ms^Xm, Ms^Xm, Ms^Xm, Ms^Xm, Ms, Ms, Ms^Xm, Ms^Xm, Ms, Ms, Ms, Rb, Ms^Xm, Ms^Xm, Ms^Xm, Ms, Ms, Ms, Ms, Ms
Aa^Es, Ce, 2 Kea, Ce, Re^Vct, Aa^Fpa, Aa^Fpa, Rd, Rd, Rd, Aa^Fpa, Rd, Rd, Aa, Rd, Rd, Rd, Aa, Aa, Aa^Fpa, Aa^Fpa, Ai, Ai, Ms, Ms, Ms, Ms, Ms^Xm, Ms^Xm, Ms^Xm, Ms^Xm, Ms, Ms, Ms^Xm, Ms^Xm, Ms^Xm, Ms, Rb, Ha, Ms^Xm, Ms^Xm, Ms, Ms, Ms, Ms, Ms
Aa^Fpa, Ce, Ce, Ce, Aa^Fpa, Aa^Fpa, Aa^Fpa, Aa^Fpa, Ha, Aa^Fpa, Ha, Ha, Ha, Rd, Aa^Fpa, Aa^Fpa, Aa^Fpa, Rd, Rd, Aa, Aa, Aa^Fpa, Aa^Fpa, Ai, Ha, Ms, Ms^Xm, Ms^Xm, Ms, Ms, Ms, Ms, Ms^Xm, Ms^Xm, Ms, Ms, Ms, Rb, Rb, Ha, Ms^Xm, Ms^Xm, Ms, Ms, Ms, Ms
Ha, Ha, Ha, Re^Vct, Aa^Fpa, Aa^Fpa, Aa^Vea, Ha, Ms, Ha, Ms, Ha, Ms^Xm, Ha, Ha, Aa^Fpa, Aa^Fpa, Aa, Aa, Rd, Aa, Aa, Ai, Ai, Ha, Ha^Vhha, Ms^Xm, Ms, Ms^Xm, Ms, Ms, Ms^Xm, Ms^Xm, Ms^Xm, Ms, Ms, Ms^Xm, Ms^Xm, Ms, Rb, Rb, Ms^Xm, Ms, Ms, Ms, Ms
Ms^Xm, Ms, Ms^Xm, Ha, Ha, Ha, Ha, Ha, Ms, Ms^Xm, Ms^Xm, Ms^Xm, Ms, Ms, Ha, Aa^Fpa, Aa^Fpa, Aa^Fpa, Aa, Rd, Aa, Aa, Ai, Ai, Ai, Ha, Ha, Ms^Xm, Ms^Xm, Ms^Xm, Ai, Ms^Xm, Ai, Ms, Wo, Ai, Ms, Ms^Xm, Ms^Xm, Ha, Rb, Ms^Xm, Ms, Ms, Ms^Xm, Ms^Xm
Ms^Xm, Ms^Xm, Ms, Ms^Xm, Ms^Xm, Ms^Xm, Ms^Xm, Ms^Xm, Ms^Xm, Ms^Xm, Ms, Ms^Xm, Ha, Ha, Aa^Fpa, Aa^Fpa, Aa, Aa^Es, Aa, Rd, Aa, Aa^Fpa, Ai, Ai, Ai, Ha, Ha, Ha, Ms, Ms, Ms, Wo, Wo, Wo, Ms, Ms, Ms^Xm, Ms, Ms, Ha, Rb, Ha, Ms^Xm, Ms, Ms, Ms
Ms, Ms^Xm, Ms^Xm, Ms^Xm, Ms, Ms, Ms, Ms, Ms, Ms, Ha, Ha, Aa^Fpa, Aa^Fpa, Aa^Fpa, Aa, Aa, Aa, Rd, Rd, Aa^Fpa, Ai, Ai, Ai, Ai, Ai, Ha, Ha, Ha, Ms, Ms, Ms^Xm, Wo, Ms, Ai, Ms, Ms, Ms^Xm, Ms^Xm, Ha, Rb, Ha, Ms^Xm, Ms, Ms, Ms
Ha, Ms, Ms, Ms, Ha, Ms, Ai, Ms, Ms, Ms, Ai, Aa^Fpa, Aa, Aa, Aa, Aa, Rd, Rd, Aa^Fpa, Aa, Aa^Fpa, Aa^Fpa, Ai, Ai, Wo, Wo, Wo, Wo, Wo, Wo, Wo, Ms, Wo, Wo, Ms, Ms, Ms, Ms^Xm, Ms, Ms^Xm, Rb, Ha, Ms^Xm, Ms, Ha, Ms
Aa, Ha, Aa^Fpa, Aa^Fpa, Aa^Fpa, Aa^Fpa, Ai, Ai, Ai, Ai, Ai, Ai, Aa^Fpa, Aa^Fpa, Aa, Rd, Rd, Aa, Aa^Fpa, Aa^Fpa, Aa^Fpa, Aa^Fpa, Wo, Wo, Wo, Wo, Wo, Wo, Wo, Wo, Wo, Wo, Wo, Ms, Ms, Ms, Ms, Ms^Xm, Ms^Xm, Ms, Rb, Ms^Xm, Ha, Ha^Vhha, Ha, Ha
Aa, Aa^Fpa, Aa, Aa^Fpa, Aa, Ai, Ai, Ai, Ai, Ai, Aa^Fpa, Aa, Aa^Fpa, Aa, Aa, Rd, Aa, Rd, Rd, Aa^Fpa, Aa, Aa, Wo, Wo, Wo, Wo^Bw\, Rrc, Rrc^Vhca, Rrc, Wo, Rrc, Wo, Wo, Wo, Wo, Ms, Ms, Ms^Xm, Ms, Ms, Rb, Ha, Aa^Fpa, Aa^Fpa, Aa^Fpa, Aa^Fpa
Aa^Fpa, Aa^Es, Aa, Aa^Fpa, Aa^Fpa, Aa^Fpa, Aa^Fpa, Aa^Fpa, Aa^Fpa, Aa, Aa^Fpa, Aa^Fpa, Aa^Fpa, Aa, Aa, Rd, Aa, Aa^Fpa, Aa^Fpa, Rd, Wo^Bw\, Wo, Wo, Wo, Rrc, Rrc, Rrc, Rrc, Rrc, Rrc, Rrc^Vhca, Rrc, Wo, Wo, Wo, Wo, Ai, Ms, Ms^Xm, Ms^Xm, Aa, Aa^Fpa, Aa^Fpa, Aa^Fpa, Ai, Ai
Aa, Aa, Aa, Aa, Aa^Fpa, Aa^Fpa, Aa^Fpa, Aa^Fpa, Aa, Aa^Fpa, Aa^Fpa, Aa, Aa^Es, Aa, Aa, Rd, Aa^Fpa, Aa^Fpa, Aa, Aa, Wo, Wo^Bw\, Wo^Bw\, Rrc, Rrc, Rrc, Cha, Kha, Cha, Rrc, Rrc, Rrc, Rrc, Wo, Wo, Wo, Wo, Ai, Ai, Ai, Ai, Ai^Bw\r, Aa, Ai, Aa^Fpa, Aa^Fpa
Aa, Aa^Fpa, Aa^Fpa, Aa^Fpa, Aa^Fpa, Aa^Fpa, Aa^Fpa, Aa, Aa, Aa^Fpa, Aa, Aa, Aa, Aa, Rd, Rd, Aa^Fpa, Aa, Wo, Wo, Wo, Wo, Rrc^Ebn, Rrc, Rrc, Kha, Ch, Ch, Ch, Kha, Rrc, Rrc, Rrc, Wo^Bw/, Wo, Wo, Wo, Ai, Ha, Aa^Fpa, Aa^Fpa, Aa, Aa^Fpa, Aa^Fpa, Aa^Fpa, Aa^Fpa
Aa, Aa^Fpa, Aa^Fpa, Aa^Fpa, Aa^Fpa, Aa^Fpa, Aa^Fpa, Aa^Fpa, Aa^Fpa, Aa, Aa, Aa, Rd, Rd, Aa^Fpa, Aa^Fpa, Aa, Aa, Wo, Wo, Wo, Wo, Rrc, Rrc^Vhca, Rrc, Cha, Ch, Ch, Ch, Cha, Rrc, Rrc^Vhca, Rrc, Wo, Wo, Wo, Wo, Aa^Fpa, Aa^Fpa, Aa^Fpa, Aa^Fpa, Aa^Fpa, Aa^Fpa, Aa^Fpa, Aa^Fpa, Aa^Fpa
Aa, Aa^Fpa, Aa^Fpa, Aa^Fpa, Aa^Fpa, Aa^Fpa, Aa^Fpa, Aa^Fpa, Aa, Aa^Fpa, Aa, Rd, Aa, Aa^Fpa, Aa^Fpa, Aa^Fpa, Aa, Wo, Wo, Wo, Wo, Rrc, Rrc, Rrc, Rrc, Kha, Cha, Ch, Cha, Kha, Rrc, Rrc, Rrc^Ebn, Wo, Wo, Wo, Wo, Aa^Fpa, Aa^Fpa, Aa^Fpa, Aa^Fpa, Aa, Aa^Fpa, Aa^Fpa, Aa^Fpa, Aa^Fpa
Aa, Aa, Aa^Fpa, Aa^Fpa, Aa^Fpa, Aa^Fpa, Aa^Vea, Aa, Aa^Fpa, Aa^Fpa, Aa, Rd, Aa, Aa, Aa^Fpa, Aa, Aa, Wo, Wo, Wo, Wo, Rrc^Ebn, Rrc, Rrc^Vhca, Rrc, Rrc, Rrc, Kha, Rrc, Rrc, Rrc, Rrc, Wo, Wo, Wo, Wo, Aa^Fpa, Aa^Fpa, Aa^Fpa, Aa^Fpa, Aa, Aa, Aa^Fpa, Aa^Fpa, Aa^Fpa, Aa^Fpa
Aa, Aa^Fpa, Aa^Fpa, Aa, Aa^Fpa, Aa^Fpa, Aa, Aa^Fpa, Aa, Aa, Aa, Rd, Aa, Aa^Fpa, Aa^Fpa, Aa, Aa, Wo, Wo, Wo, Wo, Wo, Wo^Bw/, Rrc, Rrc, Rrc^Vhca, Rrc, Rrc, Rrc, Rrc, Wo, Wo^Bw\, Wo^Bw\, Wo, Wo, Aa^Fpa, Aa, Aa^Fpa, Aa, Aa^Fpa, Aa^Fpa, Aa^Fpa, Aa^Fpa, Aa^Fpa, Aa^Fpa, Aa^Fpa
Aa^Fpa, Aa^Fpa, Aa, Aa, Aa^Fpa, Aa^Fpa, Ai, Aa^Fpa, Aa^Fpa, Aa, Aa, Rd, Rd, Aa, Aa, Aa^Fpa, Aa^Fpa, Aa, Aa, Wo, Wo^Bw/, Wo^Bw/, Wo, Wo, Wo, Rrc^Ebn, Wo, Rrc, Wo, Wo, Wo, Wo, Wo, Wo^Bw\, Rd, Aa^Fpa, Rd, Aa, Aa^Fpa, Aa^Fpa, Aa^Fpa, Aa^Fpa, Aa^Fpa, Aa^Fpa, Aa^Fpa, Aa^Fpa
Aa^Fpa, Aa, Aa^Fpa, Aa, Aa^Fpa, Ai, Ai, Ai, Ai, Aa, Aa, Aa, Aa, Rd, Aa, Aa^Fpa, Aa^Fpa, Aa^Fpa, Rd, Rd, Aa, Wo, Wo, Wo, Wo, Wo, Wo, Wo, Wo, Wo, Aa, Wo, Aa^Fpa, Aa^Fpa, Aa^Fpa, Rd, Rd, Aa, Aa^Fpa, Aa^Fpa, Aa^Fpa, Aa^Fpa, Aa^Fpa, Aa^Fpa, Aa^Fpa, Aa^Fpa
Aa^Fpa, Aa, Aa^Fpa, Aa, Aa^Fpa, Ai, Ai, Ai, Aa^Fpa, Aa^Fpa, Aa^Fpa, Aa, Aa, Rd, Rd, Aa, Aa, Rd, Aa, Aa^Fpa, Aa, Aa, Aa, Aa^Fpa, Aa^Fpa, Aa, Aa^Fpa, Wo, Aa^Fpa, Aa, Aa^Fpa, Aa^Fpa, Aa^Fpa, Aa^Fpa, Rd, Rd, Aa, Aa, Aa^Fpa, Aa^Fpa, Aa^Vea, Aa^Fpa, Aa^Fpa, Aa^Fpa, Aa^Fpa, Aa^Fpa
Aa^Fpa, Aa^Fpa, Aa^Vea, Aa^Fpa, Aa^Fpa, Aa^Fpa, Aa^Fpa, Ai, Aa^Fpa, Aa, Aa, Aa^Fpa, Aa^Fpa, Aa, Aa, Rd, Rd, Rd, Rd, Rd, Rd, Aa, Aa, Aa^Fpa, Aa^Fpa, Aa^Fpa, Aa, Aa^Fpa, Aa, Aa^Fpa, Aa, Aa^Fpa, Aa, Aa, Rd, Aa, Aa, Aa, Aa^Fpa, Aa^Fpa, Aa^Fpa, Aa^Fpa, Aa^Fpa, Aa^Fpa, Aa^Fpa, Aa^Fpa
Aa^Fpa, Aa^Fpa, Aa^Fpa, Aa^Fpa, Aa^Fpa, Aa^Fpa, Aa^Fpa, Aa, Aa, Aa^Fpa, Aa^Fpa, Aa^Fpa, Aa^Fpa, Aa^Fpa, Aa^Fpa, Aa, Aa, Aa, Aa, Aa, Aa, Rd, Rd, Aa^Fpa, Rd, Rd, Rd, Rd, Rd, Rd, Rd, Aa, Rd, Rd, Aa, Rd, Rd, Aa, Aa, Aa^Fpa, Aa, Aa^Fpa, Aa^Fpa, Aa^Fpa, Aa^Fpa, Aa^Es
Aa^Fpa, Aa^Fpa, Aa^Fpa, Aa, Aa^Fpa, Aa^Fpa, Aa^Fpa, Aa, Aa, Aa^Vea, Aa^Fpa, Aa, Aa, Aa^Fpa, Aa^Fpa, Aa^Fpa, Aa, Aa, Aa^Fpa, Aa^Fpa, Aa^Fpa, Aa, Aa, Rd, Aa, Aa, Aa, Aa, Aa, Aa, Aa, Rd, Aa, Aa, Aa, Aa, Aa, Rd, Rd, Aa, Aa, Aa, Cea, Cea, Cea, Aa
Aa, Aa, Aa^Fpa, Cer^Edb, Cer^Edb, Aa^Fpa, Aa^Fpa, Aa^Fpa, Aa^Fpa, Aa^Fpa, Aa^Fpa, Aa, Aa^Fpa, Aa, Aa, Aa^Fpa, Aa, Aa^Fpa, Aa^Vea, Aa, Aa^Fpa, Aa, Aa, Aa, Aa, Aa, Aa, Aa, Aa^Fpa, Aa, Aa^Fpa, Aa, Aa, Aa^Es, Aa^Fpa, Aa^Fpa, Aa, Aa, Aa^Fpa, Rd, Rd, Aa, Cea, Kea, Cea, Aa
Aa, Aa, Aa^Fpa, Ker^Edb, Cer^Edb, Aa^Fpa, Aa^Fpa, Aa^Fpa, Aa^Fpa, Aa^Fpa, Aa^Fpa, Aa^Fpa, Aa^Fpa, Aa^Fpa, Aa^Fpa, Aa^Fpa, Aa^Fpa, Aa^Fpa, Aa^Fpa, Aa^Fpa, Aa^Fpa, Aa^Fpa, Aa^Fpa, Aa^Es, Aa^Fpa, Aa^Fpa, Aa^Fpa, Aa^Fpa, Aa^Fpa, Aa^Fpa, Aa^Fpa, Aa^Fpa, Aa, Aa^Fpa, Aa^Vea, Aa, Aa^Fpa, Aa, Aa^Fpa, Aa, Aa, Rd, Aa, Cea, Rd, Aa
Aa, Aa^Fpa, Aa^Fpa, Aa^Fpa, Aa^Fpa, Aa^Fpa, Aa^Fpa, Aa^Fpa, Aa^Fpa, Aa^Fpa, Aa, Aa^Fpa, Aa, Aa^Fpa, Aa^Fpa, Aa, Aa^Fpa, Aa^Fpa, Aa^Fpa, Aa^Fpa, Aa^Fpa, Aa^Fpa, Aa^Fpa, Aa^Fpa, Aa^Fpa, Aa^Fpa, Aa^Fpa, Aa^Fpa, Aa^Fpa, Aa, Aa^Fpa, Aa^Fpa, Aa^Fpa, Aa^Fpa, Aa^Fpa, Aa^Fpa, Aa^Fpa, Aa^Fpa, Aa^Fpa, Aa^Fpa, Aa^Fpa, Aa, Aa^Fpa, Aa, Aa, Rd
Aa, Aa, Aa^Fpa, Aa^Fpa, Aa^Fpa, Aa^Fpa, Aa, Aa^Fpa, Aa, Aa^Fpa, Aa, Aa^Fpa, Aa^Fpa, Aa^Fpa, Aa, Aa^Fpa, Aa^Fpa, Aa^Fpa, Aa^Fpa, Aa^Fpa, Aa, Aa^Fpa, Aa, Aa, Aa, Aa, Aa, Aa, Aa, Aa, Aa, Aa, Aa, Aa, Aa, Aa, Aa, Aa^Fpa, Aa, Aa^Fpa, Aa^Fpa, Aa^Fpa, Aa^Fpa, Aa^Fpa, Aa, Aa^Es
