Xu, Xu, Xu, Xu, Xu, Xu, Xu, Xu, Xu, Xu, Xu, Uh, Uh^Dr, Xu, Xu, Xu, Xu, Xu, Xu, Xu, Xu, Xu, Xu, Xu, Xu, Xu, Xu, Xu, Xu, Xu, Xu, Xu, Xu, Xu, Xu, Xu, Xu, Xu, Xu, Xu, Xu, Xu, Xu, Xu, Xu, Xu, Xu, Xu, Xu, Xu, Xu, Xu, Xu, Xu, Xu, Xu, Xu, Xu, Xu, Xu, Uh, Ur, Uh, Xu, Xu, Xu, Xu, Xu, Xu, Xu, Xu, Xu, Xu, Xu, Xu, Xu, Xu, Xu, Xu, Xu
Xu, Xu, Xu, Xu, Xu, Xu, Xu, Xu, Xu, Xu, Uh^Dr, Uh^Dr, Uh^Dr, Xu, Xu, Xu, Xu, Xu, Xu, Xu, Xu, Xu, Xu, Xu, Xu, Xu, Xu, Xu, Xu, Xu, Xu, Xu, Xu, Xu, Xu, Xu, Xu, Xu, Xu, Xu, Xu, Xu, Xu, Xu, Xu, Xu, Xu, Xu, Xu, Xu, Xu, Xu, Xu, Xu, Xu, Xu, Xu, Xu, Xu, Xu, Uu, Ur, Uu, Xu, Xu, Xu, Xu, Xu, Xu, Xu, Xu, Xu, Xu, Xu, Xu, Xu, Xu, Xu, Xu, Xu
Xu, Xu, Xu, Xu, Xu, Xu, Xu, Xu, Xu, Xu, Uh, Uh^Dr, Uh^Edb, Xu, Xu, Xu, Uue^Esd, Xu, Uue^Edt, Xu, Xu, Xu, Xu, Xu, Xu, Xu, Xu, Xu, Xu, Xu, Xu, Xu, Xu, Xu, Xu, Xu, Xu, Xu, Xu, Xu, Xu, Xu, Xu, Xu, Xu, Xu, Xu, Xu, Xu, Xu, Xu, Xu, Xu, Xu, Xu, Xu, Xu, Xu, Xu, Uh, Ur, Ur, Uh, Xu, Xu, Xu, Xu, Xu, Xu, Xu, Xu, Xu, Xu, Xu, Xu, Xu, Xu, Xu, Xu, Xu
Xu, Xu, Xu, Xu, Xu, Xu, Xu, Xu, Xu, Xu, Uu^Vu, Uh^Br|, Ur^Edb, Uh^Dr, Uu^Efs, Uue^Dr, Uu^Br|, Uu, Uu^Edt, Uue^Edt, Uue^Edt, Xu, Xu, Xu, Xu, Xu, Xu, Xu, Xu, Xu, Xu, Xu, Xu, Xu, Xu, Xu, Xu, Xu, Xu, Xu, Xu, Xu, Xu, Xu, Xu, Xu, Xu, Xu, Xu, Xu, Xu, Xu, Xu, Xu, Xu, Xu, Xu, Xu, Xu, Uu, Ur, Uu, Uh, Xu, Xu, Xu, Xu, Xu, Xu, Xu, Xu, Xu, Xu, Xu, Xu, Xu, Xu, Xu, Xu, Xu
Xu, Xu, Xu, Xu, Xu, Xu, Xu, Xu, Uh, Uh^Dr, Ur, Ur^Br|, Ur^Br\, Ur^Edb, Ur, Uu, Uu^Br/, Uu^Br/, Uu^Edb, Uu^Edb, Xu, Xu, Xu, Xu, Xu, Xu, Xu, Xu, Xu, Xu, Xu, Xu, Xu, Xu, Xu, Xu, Xu, Xu, Xu, Xu, Xu, Xu, Xu, Xu, Xu, Xu, Xu, Xu, Xu, Xu, Xu, Xu, Xu, Xu, Xu, Xu, Xu, Xu, Uh, Ur, Ur, Uu, Xu, Xu, Xu, Xu, Xu, Xu, Xu, Xu, Xu, Xu, Xu, Xu, Xu, Xu, Xu, Xu, Xu, Xu
Xu, Xu, Xu, Xu, Xu, Xu, Xu, Xu, Uu, Uu, Ur^Edb, Ur^Br|, Uh, Ur^Br\, Ur^Br/, Ur^Br/, Uu^Edb, Uu^Br\, Uu, Uue^Esd, Uue^Esd, Xu, Xu, Xu, Xu, Xu, Xu, Xu, Xu, Xu, Xu, Xu, Xu, Xu, Xu, Xu, Xu, Xu, Xu, Xu, Xu, Xu, Xu, Xu, Xu, Xu, Xu, Xu, Xu, Xu, Xu, Xu, Xu, Xu, Xu, Xu, Xu, Xu, Uu, Ur, Ur, Uu, Qlf, Xu, Xu, Xu, Xu, Xu, Xu, Xu, Xu, Xu, Xu, Xu, Xu, Xu, Xu, Xu, Xu, Xu
Xu, Xu, Xu, Xu, Xu, Xu, Xu, Uu, Ur, Ur^Edb, Ur^Br|, Ur^Br/, Xu, Uh, Uh, Ur^Dr, Uu^Dr, Uu, Uue, Uue^Esd, Uue^Edt, Xu, Xu, Xu, Xu, Xu, Xu, Xu, Xu, Xu, Xu, Xu, Xu, Xu, Xu, Xu, Xu, Xu, Xu, Xu, Xu, Xu, Xu, Xu, Xu, Xu, Xu, Xu, Xu, Xu, Xu, Xu, Xu, Xu, Xu, Xu, Xu, Qlf, Qlf, Ur, Ur, Qlf, Qlf, Xu, Xu, Xu, Xu, Xu, Xu, Xu, Xu, Xu, Xu, Xu, Xu, Xu, Xu, Xu, Xu, Xu
Xu, Xu, Xu, Xu, Xu, Xu, Xu, Uu, Ur, Ur^Edb, Ur^Br/, Ur, Ur, Xu, Xu, Xu, Xu, Xu, Xu, Uue^Edt, Xu, Xu, Xu, Xu, Xu, Xu, Xu, Xu, Xu, Xu, Xu, Xu, Xu, Xu, Xu, Xu, Xu, Xu, Xu, Xu, Xu, Xu, Xu, Xu, Xu, Xu, Xu, Xu, Xu, Xu, Xu, Xu, Xu, Xu, Xu, Xu, Xu, Qlf, Xu, Uu, Ur, Uu, Uu, Qlf, Qlf, Qlf, Xu, Xu, Xu, Xu, Xu, Xu, Xu, Xu, Xu, Xu, Xu, Xu, Xu, Xu
Xu, Xu, Xu, Xu, Xu, Xu, Xu, Ur, Ur^Br|, Ur^Br/, Xu, Ur^Br\, Ur^Br\, Ur, Ur, Xu, Xu, Xu, Xu, Xu, Xu, Xu, Ww^Dr, Xu, Xu, Xu, Ur^Dr, Xu, Ur^Dr, Ur^Dr, Xu, Xu, Xu, Xu, Xu, Xu, Xu, Xu, Xu, Xu, Xu, Xu, Xu, Xu, Xu, Xu, Xu, Xu, Xu, Xu, Xu, Xu, Xu, Xu, Xu, Xu, Xu, Xu, Xu, Uh, Uh, Ur, Ur, Qlf, Ur, Qlf, Qlf, Xu, Qlf, Xu, Xu, Xu, Xu, Xu, Xu, Xu, Xu, Xu, Xu, Xu
Xu, Xu, Xu, Xu, Xu, Xu, Ur, Ur, Ur^Br|, Uu^Uf, Xu, Xu, Xu, Ur^Br\, Ur^Br\, Ur, Ur^Br/, Uu^Vud, Ww^Dr, Xu, Wwr, Xu, Wwr, Ww^Dr, Ur, Ur^Dr, Ur^Br/, Ur^Dr, Ur^Edb, Ur^Edt, Ur^Edb, Ur^Dr, Xu, Xu, Xu, Xu, Xu, Xu, Xu, Xu, Ql, Ql, Qlf, Qlf, Cer, Ker, Cer, Xu, Xu, Xu, Xu, Xu, Xu, Xu, Xu, Xu, Xu, Xu, Xu, Xu, Xu, Uu, Uu, Ur, Ur, Ur, Ur, Qlf, Qlf, Qlf, Qlf, Xu, Xu, Xu, Xu, Xu, Xu, Xu, Xu, Xu
Xu, Xu, Xu, Xu, Xu, Xu, Ur^Edb, Ur^Edb, Ur^Br|, Uu^Uf, Xu, Xu, Xu, Xu, Xu, Ur^Br\, Ur, Ur^Br\, Ur^Br\, Wwr, Ww, Wwr, Ww, Ww^Dr, Ww, Wwr, Wwr, Ur^Edb, Ur^Edb, Ur^Edb, Ur^Edb, Ur, Xu, Xu, Xu, Xu, Xu, Xu, Xu, Xu, Qlf, Uh, Ur, Ur, Ur, Cer, Ur, Qxu, Qxu, Ql, Qxu, Qxu, Ql, Xu, Qlf, Xu, Xu, Xu, Xu, Xu, Xu, Xu, Xu, Uu, Qlf, Ur, Ur, Ur, Qlf, Qlf, Qlf, Qlf, Xu, Xu, Xu, Xu, Xu, Xu, Xu, Xu
Xu, Xu, Xu, Xu, Xu, Uu, Ur^Edb, Ur^Br/, Uh, Xu, Xu, Xu, Xu, Xu, Xu, Xu, Xu, Ur, Xu, Ww, Ww, Ww, Ww, Ww, Wwr, Ww, Xu, Ur^Eb, Xu, Uu^Vud, Xu, Xu, Xu, Xu, Xu, Xu, Xu, Xu, Xu, Xu, Qlf, Uu, Ur, Qlf, Qlf, Qlf, Ql, Ur, Ur, Qlf, Ql, Ql, Qlf, Qlf, Ur, Qlf, Qlf, Xu, Xu, Xu, Xu, Xu, Qlf, Qlf, Qlf, Qlf, Uu, Ur, Ur, Qlf, Qlf, Qlf, Qlf, Xu, Xu, Xu, Xu, Xu, Xu, Xu
Xu, Xu, Xu, Xu, Uh, Ur, Ur^Br/, Ur^Br|, Xu, Xu, Xu, Xu, Xu, Xu, Xu, Xu, Xu, Xu, Xu, Xu, Ww, Ww, Ww^Dr, Xu, Xu, Xu, Xu, Xu, Xu, Xu, Xu, Xu, Xu, Xu, Xu, Xu, Xu, Xu, Xu, Qlf, Ur, Ur, Qlf, Ql, Qxu, Qxu, Qlf, Qlf, Ur, Qlf, Qlf, Ql, Ur, Ur, Xu, Ur, Ur, Xu, Xu, Xu, Xu, Xu, Xu, Qlf, Xu, Qlf, Xu, Uu, Ur, Qlf, Qlf, Qlf, Qlf, Qlf, Xu, Xu, Xu, Xu, Xu, Xu
Xu, Xu, Xu, Xu, Uh, Ur, Ur^Br|, Uu^Vu, Xu, Xu, Xu, Xu, Xu, Xu, Qxu, Xu, Wwr, Ww^Dr, Ww, Ww, Ww^Dr, Uu, Qxu, Qxu, Qxu, Xu, Xu, Xu, Xu, Xu, Xu, Xu, Xu, Xu, Xu, Xu, Xu, Xu, Uh, Uh, Ur, Qlf, Xu, Xu, Xu, Xu, Xu, Qlf, Qlf, Ur, Qlf, Qlf, Ur, Xu, Xu, Qlf, Xu, Ur, Ur, Xu, Xu, Xu, Xu, Xu, Xu, Xu, Qlf, Xu, Ur, Ur, Uu, Qlf, Qlf, Qlf, Qlf, Xu, Xu, Xu, Xu, Xu
Xu, Xu, Xu, Xu, Uu^Br/, Ur^Br/, Ur^Edb, Ur^Br\, Ur^Br\, Xu, Xu, Xu, Xu, Xu, Ww, Ww^Dr, Ww, Ww, Wwr, Wwr, Xu, Qxu, Qxu, Qxu, Qxu, Xu, Xu, Xu, Xu, Xu, Xu, Xu, Xu, Xu, Cud, Kud, Cud, Xu, Uu^Dr, Ur, Ur, Qlf, Xu, Xu, Xu, Xu, Xu, Qlf, Xu, Ur, Ur, Ur, Xu, Xu, Ql, Xu, Xu, Qlf, Qlf, Ur, Xu, Xu, Xu, Xu, Xu, Xu, Qlf, Qlf, Ur, Ur, Uu, Qlf, Qlf, Qlf, Qlf, Xu, Xu, Xu, Xu, Xu
Xu, Xu, Xu, Xu, Xu, Uu, Uu, Ur^Edb, Ur^Br|, Xu, Xu, Xu, Xu, Xu, Ww, Ww, Ww, Ww, Uu, Xu, Xu, Qxu, Qxu, Qxu, Qxu, Qxu, Xu, Xu, Xu, Xu, Uu, Xu, Uu, Cud, Cud, Cud, Cud, Xu, Uu^Dr, Ur, Uu, Xu, Xu, Xu, Xu, Xu, Xu, Xu, Qlf, Ur, Xu, Xu, Uh, Uh, Uh^Edb, Uh, Uh, Xu, Xu, Ur, Ur, Xu, Xu, Xu, Xu, Xu, Xu, Xu, Uh, Ur, Uu, Qlf, Qlf, Qlf, Qlf, Xu, Xu, Xu, Xu, Xu
Xu, Xu, Xu, Xu, Xu, Uh, Ur^Edb, Ur^Edt, Ur^Br|, Xu, Xu, Xu, Xu, Xu, Uu^Uf, Ww, Ww, Ww, Uu, Xu, Uu, Xu, Xu, Qxu, Uu^Dr, Qxu, Uu^Dr, Xu, Uu, Uu, Uu, Uu, Uu, Cud, Cud, Cud, Cud, Xu, Uu^Dr, Ur, Uu, Xu, Xu, Xu, Xu, Xu, Qlf, Qlf, Qlf, Qlf, Xu, Xu, Uh, Uh, Uh, Uu, Uh, Ql, Xu, Xu, Ur, Qlf, Qlf, Xu, Xu, Xu, Xu, Xu, Uh, Ur, Uu, Qlf, Qlf, Qlf, Qlf, Xu, Xu, Xu, Xu, Xu
Xu, Xu, Xu, Xu, Xu, Uue, Ur, Ur, Uu^Br|, Xu, Xu, Xu, Xu, Xu, Ww, Ww, Ww, Ww, Ww, Wwr, Ww, Ww^Dr, Wwr, Uu^Dr, Uu, Uu, Uu, Uu, Uu, Uu, Xu, Uu, Uu, Cud, Cud, Cud, Cud, Xu, Ur^Dr, Ur, Uu, Xu, Xu, Xu, Xu, Xu, Qlf, Qlf, Xu, Qlf, Xu, Xu, Xu, Qxu, Xu, Uu, Xu, Uh, Xu, Xu, Ur, Qlf, Qlf, Xu, Xu, Xu, Xu, Xu, Uu^Xo, Ur, Uu^Xo, Qlf, Qlf, Qlf, Qlf, Xu, Xu, Xu, Xu, Xu
Xu, Xu, Xu, Xu, Xu, Uue^Edb, Ur^Edb, Ur, Uu^Br|, Xu, Xu, Xu, Xu, Xu, Xu, Ww, Ww, Ww, Ww, Ww, Wo, Ww, Wo, Ww, Ww, Wwr, Wwr, Uu, Xu, Xu, Xu, Xu, Xu, Xu, Xu, Kud, Xu, Xu, Uu, Ur, Uu, Xu, Xu, Xu, Xu, Xu, Ql, Qlf, Qlf, Xu, Xu, Xu, Qlf, Xu, Ur, Uu, Xu, Xu, Xu, Qlf, Qlf, Ur, Qlf, Xu, Xu, Xu, Xu, Xu, Qlf, Ur^Xo, Uu, Qlf^Xo, Qlf^Xo, Qlf^Xo, Qlf^Xo, Xu, Xu, Xu, Xu, Xu
Xu, Xu, Xu, Xu, Xu, Uu^Dr, Ur^Edb, Ur, Ur^Br|, Xu, Xu, Xu, Xu, Xu, Xu, Ww, Ww, Ww, Ww, Ww, Ww, Wo, Wo, Wo, Ai, Ww, Xu, Xu, Xu, Xu, Xu, Xu, Xu, Xu, Xu, Xu, Xu, Xu, Qlf, Ur, Uu, Xu, Xu, Xu, Xu, Xu, Ql, Qlf, Qlf, Qlf, Qlf, Xu, Qlf, Qlf, Ur, Ur, Xu, Xu, Qlf, Qlf, Ur, Ur, Xu, Xu, Xu, Xu, Qlf, Qlf, Qlf, Ur, Qlf, Qlf, Qlf, Qlf, Qlf, Xu, Xu, Xu, Xu, Xu
Xu, Xu, Xu, Xu, Xu, Xu, Uu, Ur, Ur^Br|, Xu, Xu, Xu, Xu, Xu, Xu, Xu, Xu, Ww, Ww, Ww, Ur^Ii, Wo, Wo, Wo, Ai, Ms^Ii, Ms^Xm, Ms^Xm, Ms^Xm, Xu, Xu, Xu, Xu, Xu, Xu, Xu, Xu, Qlf, Qlf, Ur, Uu, Xu, Xu, Xu, Xu, Xu, Xu, Ql, Qlf, Qlf, Qlf, Qlf, Xu, Qlf, Ur, Ur, Qlf, Xu, Ur, Ur, Qlf, Xu, Xu, Xu, Xu, Xu, Xu, Xu, Uu, Ur, Qlf, Qlf, Qlf, Qlf, Qlf, Qlf, Xu, Xu, Xu, Xu
Xu, Xu, Xu, Xu, Xu, Xu, Uu, Ur, Ur^Br|, Xu, Xu, Xu, Xu, Xu, Xu, Xu, Xu, Xu, Wo, Wo, Wo, Wo, Ai, Ai, Ms^Ii, Ms^Ii, Ms^Xm, Ms^Xm, Ms^Xm, Ms^Xm, Xu, Xu, Xu, Xu, Xu, Xu, Xu, Qlf, Qlf, Ur, Ur, Uu, Xu, Xu, Xu, Xu, Xu, Qlf^Xo, Qlf^Xo, Qlf, Qxu, Qlf, Xu, Xu, Ur, Ur, Xu, Xu, Ur, Qlf, Ql^Xo, Xu, Xu, Xu, Xu, Xu, Xu, Uu, Ur, Ur, Qlf, Qlf, Qlf, Qlf, Qlf, Qlf, Qlf, Xu, Xu, Xu
Xu, Xu, Xu, Xu, Xu, Xu, Uu^Uf, Ur^Edb, Ur^Br|, Uu^Vu, Xu, Xu, Xu, Xu, Xu, Xu, Xu, Xu, Wo, Wo, Xu, Ai, Xu, Ms^Ii, Ms^Xm, Ms^Xm, Ms^Xm, Ms^Xm, Ms^Xm, Ms^Xm, Xu, Xu, Xu, Xu, Xu, Xu, Xu, Xu, Qlf, Qlf, Ur, Uu, Uu, Xu, Xu, Xu, Xu, Qlf^Xo, Qlf^Xo, Xu, Xu, Qxu, Ur, Ur, Ur, Ur, Ur, Ur, Ql, Ql^Xo, Ql^Xo, Ql^Xo, Xu, Xu, Xu, Xu, Qlf, Ur, Ur, Uu^Dr, Qlf, Qlf, Qlf, Qlf, Qlf, Qlf, Qlf, Xu, Xu, Xu
Xu, Xu, Xu, Xu, Xu, Xu, Uh, Ur^Edb, Ur^Edb, Ur^Br\, Ur^Br\, Uu, Uu, Xu, Xu, Xu, Xu, Xu, Xu, Xu, Xu, Xu, Ms^Xm, Ms^Xm, Ms^Xm, Ms^Xm, Ms^Xm, Ms^Xm, Ms^Xm, Ms^Xm, Xu, Xu, Xu, Xu, Xu, Xu, Xu, Xu, Xu, Qlf, Qlf, Ur, Ur, Uh, Uh, Xu, Xu, Qlf^Xo, Qlf^Xo, Xu, Xu, Xu, Ker, Ur, Ur, Ur, Ker, Qxu, Qxu, Qxu^Xo, Qxu^Xo, Ql^Xo, Xu, Xu, Uh, Qlf, Ur, Ur, Uu, Qlf, Qlf, Qlf, Qlf, Qlf, Qlf, Qlf, Qlf, Qlf, Xu, Xu
Xu, Xu, Xu, Xu, Xu, Xu, Xu, Uue^Esd, Uu^Edb, Ur^Edb, Ur, Ur^Br\, Ur^Br\, Uue, Uue, Xu, Xu, Xu, Xu, Xu, Xu, Xu, Xu, Ms^Xm, Ms^Xm, Ms^Xm, Ms^Xm, Ms^Xm, Ms^Xm, Ms^Xm, Xu, Xu, Xu, Xu, Xu, Xu, Xu, Xu, Xu, Qlf, Qlf, Ur, Ur, Ur, Ur, Xu, Qlf^Xo, Qlf^Xo, Qlf^Xo, Xu, Qxu, Qxu, Qxu, Cer, Ur, Cer, Qxu, Qxu, Qxu, Qxu^Xo, Qxu^Xo, Ql^Xo, Xu, Xu, Uu, Uu, Ur, Uu, Qlf, Qlf, Qlf, Qlf, Qlf, Qlf, Qlf, Qlf, Qlf, Qlf, Xu, Xu
Xu, Xu, Xu, Xu, Xu, Xu, Xu, Xu, Xu, Uu, Uu, Ur, Ur, Ur^Br\, Ur^Br|, Xu, Xu, Xu, Xu, Xu, Xu, Xu, Xu, Xu, Xu, Ms^Xm, Xu, Ms^Xm, Xu, Xu, Xu, Xu, Xu, Xu, Xu, Xu, Xu, Xu, Xu, Xu, Xu, Xu, Uh, Ur, Ur, Ur, Qlf, Qlf^Xo, Xu, Xu, Xu, Qxu, Qxu, Cer, Ur, Cer, Qxu, Qxu, Qxu, Qxu^Xo, Xu, Xu, Qlf, Xu, Ur, Ur, Uu, Uu, Qlf, Qlf, Qlf, Qlf, Qlf, Qlf, Qlf, Qlf, Qlf, Qlf, Xu, Xu
Xu, Xu, Xu, Xu, Xu, Xu, Xu, Xu, Xu, Xu, Xu, Uu, Uu^Edb, Ur^Edb, Ur^Br|, Uu^Uf, Xu, Xu, Xu, Xu, Xu, Xu, Xu, Xu, Xu, Xu, Xu, Xu, Xu, Xu, Xu, Xu, Xu, Xu, Xu, Xu, Xu, Xu, Xu, Xu, Xu, Xu, Xu, Uh, Uu, Ur, Ur, Ql, Ur, Xu, Xu, Xu, Qxu, Cer, Ur, Cer, Qxu, Qxu, Qxu, Xu, Qlf, Qlf, Ur, Ur, Uh, Qlf, Qlf, Qlf, Qlf, Qlf, Qlf, Qlf, Xu, Qlf, Qlf, Qlf, Qlf, Qlf, Xu, Xu
Xu, Xu, Xu, Xu, Xu, Xu, Xu, Xu, Xu, Xu, Xu, Xu, Uu^Vu, Ur^Edb, Ur^Br|, Uu^Uf, Xu, Xu, Xu, Xu, Xu, Xu, Xu, Xu, Xu, Xu, Xu, Xu, Xu, Xu, Xu, Xu, Xu, Xu, Xu, Xu, Xu, Xu, Xu, Xu, Xu, Xu, Xu, Xu, Xu, Uu, Cer, Ur, Ur, Ur, Ur, Ur, Ur, Ur, Ur, Ur, Ur, Qxu, Ur, Qlf, Ur, Ur, Uh, Uh, Uh, Qlf, Qlf, Qlf, Qlf, Qlf, Qlf, Qlf, Xu, Xu, Qlf, Qlf, Qlf, Qlf, Xu, Xu
Xu, Xu, Xu, Xu, Xu, Xu, Xu, Xu, Xu, Xu, Xu, Xu, Uu, Ur, Ur^Br|, Uu, Xu, Xu, Xu, Xu, Xu, Xu, Xu, Xu, Xu, Xu, Xu, Xu, Xu, Xu, Xu, Xu, Xu, Xu, Xu, Xu, Xu, Xu, Xu, Xu, Xu, Xu, Xu, Xu, Xu, Xu, Xu, Cer, Cer, Ur, Ur, Ur, Ur, Ur, Ur^Edt, Ur^Edt, Ur^Edt, Ur, Ur, Ur, Ur, Uh, Cer, Cer, Xu, Xu, Xu, Qlf, Qlf, Qlf, Xu, Xu, Xu, Xu, Xu, Qlf, Qlf, Qlf, Xu, Xu
Xu, Xu, Xu, Xu, Xu, Xu, Xu, Xu, Xu, Xu, Xu^Efs, Uu^Uf, Ur^Edb, Ur^Edb, Ur, Uu^Br\, Uu^Br\, Xu, Uue^Esd, Xu, Xu, Xu, Xu, Xu, Xu, Xu, Xu, Xu, Xu, Xu, Xu, Xu, Xu, Xu, Xu, Xu, Xu, Xu, Xu, Xu, Xu, Xu, Xu, Xu, Xu, Xu, Xu, Xu, Xu, Ker, Cer, Ur, Ur, Ur, Ur^Edt, Ur^Edt, Ur^Edt, Ur, Ur, Ur, Ker, Cer, Xu, Xu, Xu, Xu, Xu, Qlf, Qlf, Qlf, Xu, Xu, Xu, Xu, Xu, Qlf, Qlf, Qlf, Xu, Xu
Xu, Xu, Xu, Xu, Xu, Xu, Xu, Xu, Xu, Xu, Uu^Efs, Uu, Ur^Edb, Ur^Edb, Uu, Uu, Uu, Uu^Br\, Uu^Br\, Uue, Uu^Edb, Xu, Xu, Xu, Xu, Xu, Xu, Xu, Xu, Xu, Xu, Xu, Xu, Xu, Xu, Xu, Xu, Xu, Xu, Xu, Xu, Xu, Xu, Xu, Xu, Xu, Xu, Xu, Xu, Xu, Qlf, Uh, Cer, Ur, Ur, Ur, Cer, Uh, Qlf, Cer, Xu, Xu, Xu, Xu, Xu, Xu, Qlf, Qlf, Qlf, Qlf, Xu, Xu, Xu, Xu, Xu, Qlf, Qlf, Qlf, Qlf, Xu
Xu, Xu, Xu, Xu, Xu, Xu, Xu, Xu, Cud, Cud, Cud, Ur, Ur, Ur, Xu^Efs, Xu^Efs, Xu, Uue^Edt, Uue^Edt, Uu^Br\, Uu^Br\, Uue^Edt, Uue^Edt, Xu, Xu, Xu, Xu, Xu, Xu, Xu, Xu, Xu, Xu, Xu, Xu, Xu, Xu, Xu, Xu, Xu, Xu, Xu, Xu, Xu, Xu, Xu, Xu, Xu, Xu, Xu, Xu, Qlf, Cer, Cer, Cer, Cer, Cer, Qlf, Qlf, Qlf, Xu, Xu, Qlf, Xu, Qlf, Qlf, Qlf, Qlf, Qlf, Xu, Xu, Xu, Xu, Xu, Xu, Qlf, Qlf, Qlf, Qlf, Xu
Xu, Xu, Xu, Xu, Xu, Xu, Xu, Cud, Cud, Cud, Cud, Ur^Edb, Ur, Uu^Eb, Xu, Xu, Xu, Xu, Uue, Uu^Br|, Uu^Br\, Uu^Br\, Uu^Br|, Uue^Edt, Xu, Xu, Xu, Xu, Xu, Xu, Xu, Xu, Xu, Xu, Xu, Xu, Xu, Xu, Xu, Xu, Xu, Xu, Xu, Xu, Xu, Xu, Xu, Xu, Xu, Xu, Xu, Xu, Cer, Cer, Ker, Cer, Cer, Xu, Qlf, Qlf, Qlf, Qlf, Qlf, Qlf, Qlf, Qlf, Qlf, Qlf, Qlf, Qlf, Xu, Xu, Xu, Xu, Xu, Xu, Qlf, Qlf, Qlf, Xu
Xu, Xu, Xu, Xu, Xu, Xu, Xu, Cud, 1 Kud, Cud, Ur^Edb, Ur^Edb, Cud, Cud, Cud, Xu, Xu, Xu, Uue^Edt, Uu^Edt, Uu^Edt, Uu^Br\, Uu^Br|, Uu^Dr, Xu, Xu, Xu, Xu, Xu, Xu, Xu, Xu, Xu, Xu, Xu, Xu, Xu, Xu, Xu, Xu, Xu, Xu, Xu, Xu, Xu, Xu, Xu, Xu, Xu, Xu, Xu, Xu, Xu, Cer, Cer, Cer, Xu, Xu, Xu, Qlf, Qlf, Qlf, Qlf, Qlf, Xu, Qlf, Xu, Qlf, Xu, Qlf, Xu, Xu, Xu, Xu, Xu, Xu, Xu, Qlf, Qlf, Xu
Xu, Xu, Xu, Xu, Xu, Xu, Xu, Xu, Xu, Cud, Ur, Ur, Cud, Cud, Cud, Xu, Xu, Xu, Xu, Uu^Dr, Uu^Edt, Uu^Edb, Uu^Edb, Uue^Edt, Xu, Xu, Xu, Xu, Xu, Xu, Xu, Xu, Xu, Xu, Xu, Xu, Xu, Xu, Xu, Xu, Xu, Xu, Xu, Xu, Xu, Xu, Xu, Xu, Xu, Xu, Xu, Xu, Xu, Xu, Xu, Xu, Xu, Xu, Xu, Xu, Xu, Qlf, Xu, Xu, Xu, Xu, Xu, Xu, Xu, Xu, Xu, Xu, Xu, Xu, Xu, Xu, Xu, Qlf, Qlf, Qlf
Xu, Xu, Xu, Xu, Xu, Xu, Xu, Xu, Xu, Ur^Ii, Ur^Ii, Cud, 2 Kud, Cud, Cud, Xu, Xu, Xu, Xu, Uue^Esd, Uue^Edt, Uue^Esd, Xu, Xu, Xu, Xu, Xu, Xu, Xu, Xu, Xu, Xu, Xu, Xu, Xu, Xu, Xu, Xu, Xu, Xu, Xu, Xu, Xu, Xu, Xu, Xu, Xu, Xu, Xu, Xu, Xu, Xu, Xu, Xu, Xu, Xu, Xu, Xu, Xu, Xu, Xu, Xu, Xu, Xu, Xu, Xu, Xu, Xu, Xu, Xu, Xu, Xu, Xu, Xu, Xu, Xu, Xu, Qlf, Qlf, Qlf
Xu, Xu, Xu, Xu, Xu, Xu, Xu, Xu, Xu, Xu, Xu, Xu, Xu, Cud, Xu, Xu, Xu, Xu, Xu, Xu, Xu, Xu, Xu, Xu, Xu, Xu, Xu, Xu, Xu, Xu, Xu, Xu, Xu, Xu, Xu, Xu, Xu, Xu, Xu, Xu, Xu, Xu, Xu, Xu, Xu, Xu, Xu, Xu, Xu, Xu, Xu, Xu, Xu, Xu, Xu, Xu, Xu, Xu, Xu, Xu, Xu, Xu, Xu, Xu, Xu, Xu, Xu, Xu, Xu, Xu, Xu, Xu, Xu, Xu, Xu, Xu, Xu, Qlf, Qlf, Qlf
Xu, Xu, Xu, Xu, Xu, Xu, Xu, Xu, Xu, Xu, Xu, Xu, Xu, Xu, Xu, Xu, Xu, Xu, Xu, Xu, Xu, Xu, Xu, Xu, Xu, Xu, Xu, Xu, Xu, Xu, Xu, Xu, Xu, Xu, Xu, Xu, Xu, Xu, Xu, Xu, Xu, Xu, Xu, Xu, Xu, Xu, Xu, Xu, Xu, Xu, Xu, Xu, Xu, Xu, Xu, Xu, Xu, Xu, Xu, Xu, Xu, Xu, Xu, Xu, Xu, Xu, Xu, Xu, Xu, Xu, Xu, Xu, Xu, Xu, Xu, Xu, Xu, Xu, Qlf, Qlf
Xu, Xu, Xu, Xu, Xu, Xu, Xu, Xu, Xu, Xu, Xu, Xu, Xu, Xu, Xu, Xu, Xu, Xu, Xu, Xu, Xu, Xu, Xu, Xu, Xu, Xu, Xu, Xu, Xu, Xu, Xu, Xu, Xu, Xu, Xu, Xu, Xu, Xu, Xu, Xu, Xu, Xu, Xu, Xu, Xu, Xu, Xu, Xu, Xu, Xu, Xu, Xu, Xu, Xu, Xu, Xu, Xu, Xu, Xu, Xu, Xu, Xu, Xu, Xu, Xu, Xu, Xu, Xu, Xu, Xu, Xu, Xu, Xu, Xu, Xu, Xu, Xu, Xu, Xu, Qlf
