Xu, Xu, Xu, Xu, Xu, Xu, Xu, Xu, Xu, Xu, Xuc, Uh^Br|, Uh^Xo, Xuc, Xu, Xu, Xu, Xu, Xu, Xu, Xu, Xu, Xu, Xu, Xu, Xu, Xu, Xu, Xu, Xu, Xu, Xu, Xu, Xu, Xu, Xu, Xu, Xu, Xu, Xu, Xu, Xu, Xu, Xu, Xu, Xu, Xu, Xu, Xu, Xu, Xu, Xu, Xu, Xu, Xu, Xu, Xu, Xu, Xu, Xu, Uh, Ur, Uh, Xu, Xu, Xu, Xu, Xu, Xu, Xu, Xu, Xu, Xu, Xu, Xu, Xu, Xu, Xu, Xu, Xu
Xu, Xu, Xu, Xu, Xu, Xu, Xu, Xu, Xu, Xuc, Uh^Dr, Uh^Xo, Uh^Dr, Xuc, Xu, Xu, Xuc, Xu, Xuc, Xu, Xu, Xu, Xu, Xu, Xu, Xu, Xu, Xu, Xu, Xu, Xu, Xu, Xu, Xu, Xu, Xu, Xu, Xu, Xu, Xu, Xu, Xu, Xu, Xu, Xu, Xu, Xu, Xu, Xu, Xu, Xu, Xu, Xu, Xu, Xu, Xu, Xu, Xu, Xu, Xu, Uu, Ur, Uu, Xu, Xu, Xu, Xu, Xu, Xu, Xu, Xu, Xu, Xu, Xu, Xu, Xu, Xu, Xu, Xu, Xu
Xu, Xu, Xu, Xu, Xu, Xu, Xu, Xu, Xu, Xuc, Uh^Xo, Uh^Xo, Uh^Xo, Xuc, Xuc, Xuc, Uue^Esd, Xuc, Uue^Edt, Xuc, Xuc, Xu, Xu, Xu, Xu, Xu, Xu, Xu, Xu, Xu, Xu, Xu, Xu, Xu, Xu, Xu, Xu, Xu, Xu, Xu, Xu, Xu, Xu, Xu, Xu, Xu, Xu, Xu, Xu, Xu, Xu, Xu, Xu, Xu, Xu, Xu, Xu, Xu, Xu, Uh, Ur, Ur, Uh, Xu, Xu, Xu, Xu, Xu, Xu, Xu, Xu, Xu, Xu, Xu, Xu, Xu, Xu, Xu, Xu, Xu
Xu, Xu, Xu, Xu, Xu, Xu, Xu, Xu, Xuc, Xuc, Uu^Vu, Uh^Br|, Ur^Edb, Uh^Dr, Uu^Efs, Uue^Dr, Uu^Br|, Uu, Uu^Br/, Uue^Edt, Uue^Edt, Xuc, Xu, Xu, Xu, Xu, Xu, Xu, Xu, Xu, Xu, Xu, Xu, Xu, Xu, Xu, Xu, Xu, Xu, Xu, Xu, Xu, Xu, Xu, Xu, Xu, Xu, Xu, Xu, Xu, Xu, Xu, Xu, Xu, Xu, Xu, Xu, Xu, Xu, Uu, Ur, Uu, Uh, Xu, Xu, Xu, Xu, Xu, Xu, Xu, Xu, Xu, Xu, Xu, Xu, Xu, Xu, Xu, Xu, Xu
Xu, Xu, Xu, Xu, Xu, Xu, Xu, Xuc, Uh^Es, Uh^Dr, Ur^Es, Ur^Br|, Ur^Br\, Ur^Edb, Ur^Em, Uu, Uu^Br/, Uu^Br/, Uu^Em, Uu^Edb, Xuc, Xuc, Xu, Xu, Xu, Xu, Xu, Xu, Xu, Xu, Xu, Xu, Xu, Xu, Xu, Xu, Xu, Xu, Xu, Xu, Xu, Xu, Xu, Xu, Xu, Xu, Xu, Xu, Xu, Xu, Xu, Xu, Xu, Xu, Xu, Xu, Xu, Xu, Uh, Ur, Ur, Uu, Xu, Xu, Xu, Xu, Xu, Xu, Xu, Xu, Xu, Xu, Xu, Xu, Xu, Xu, Xu, Xu, Xu, Xu
Xu, Xu, Xu, Xu, Xu, Xu, Xuc, Xuc, Uu^Es, Uu^Es, Ur^Es, Ur^Br|, Uh^Es, Ur^Br\, Ur^Br/, Ur^Br/, Uu^Edb, Uu^Br\, Uu^Br\, Uue^Esd, Uue^Esd, Xuc, Xu, Xu, Xu, Xu, Xu, Xu, Xu, Xu, Xu, Xu, Xu, Xu, Qlf^Xo, Qlf^Xo, Qlf^Xo, Xu, Xu, Xu, Xu, Xu, Xu, Xu, Xu, Xu, Xu, Xu, Xu, Xu, Xu, Xu, Xu, Xu, Xu, Xu, Xu, Xu, Uu, Ur, Ur, Uu, Qlf, Xu, Xu, Xu, Xu, Xu, Xu, Xu, Xu, Xu, Xu, Xu, Xu, Xu, Xu, Xu, Xu, Xu
Xu, Xu, Xu, Xu, Xu, Xu, Xuc, Uu^Es, Ur^Es, Ur^Edb, Ur^Br|, Ur^Br/, Xuc, Uh^Es, Xuc, Ur^Dr, Uu^Dr, Uu, Uue, Uue^Esd, Uue^Edt, Xuc, Xu, Xu, Xu, Xu, Xu, Xu, Xu, Xu, Xu, Xu, Xu, Xu, Qlf^Xo, Qlf^Xo, Qlf^Xo, Qlf^Xo, Qlf^Xo, Xu, Xu, Xu, Xu, Xu, Xu, Xu, Xu, Xu, Xu, Xu, Xu, Xu, Xu, Xu, Xu, Xu, Xu, Qlf, Qlf, Ur, Ur, Qlf, Qlf, Xu, Xu, Xu, Xu, Xu, Xu, Xu, Xu, Xu, Xu, Xu, Xu, Xu, Xu, Xu, Xu, Xu
Xu, Xu, Xu, Xu, Xu, Xu, Xuc, Uu^Es, Ur, Ur^Edb, Ur^Br/, Ur, Ur, Xuc, Xuc, Xuc, Xuc, Xuc, Xuc, Uue^Edt, Xuc, Xuc, Xu, Xu, Xu, Xu, Xu, Xu, Xu, Xu, Xu, Xu, Xu, Xu, Qlf^Xo, Qlf^Xo, Qlf^Xo, Qlf^Xo, Qlf^Xo, Xu, Qlf^Xo, Xu, Xu, Xu, Xu, Xu, Xu, Xu, Xu, Xu, Xu, Xu, Xu, Xu, Xu, Xu, Xu, Qlf, Xu, Uu, Ur, Uu, Uu, Qlf, Qlf, Qlf, Xu, Xu, Xu, Xu, Xu, Xu, Xu, Xu, Xu, Xu, Xu, Xu, Xu, Xu
Xu, Xu, Xu, Xu, Xu, Xuc, Xuc, Ur, Ur^Br/, Ur^Br/, Xuc, Ur^Br\, Ur^Br\, Ur, Ur^Es, Xuc, Xuc, Xu, Xu, Xuc, Xu, Xu, Ww^Dr, Xu, Xu, Xu, Uh, Xu, Uh^Br/, Uh^Xo, Xu, Xu, Xu, Xu, Xu, Qlf^Xo, Qlf^Xo, Qlf^Xo, Qlf^Xo, Qlf^Xo, Qlf, Xu, Xu, Xu, Xu, Xu, Xu, Xu, Xu, Xu, Xu, Xu, Xu, Xu, Xu, Xu, Xu, Xu, Xu, Uh, Uh, Ur, Ur, Qlf, Ur, Qlf, Qlf, Xu, Qlf, Xu, Xu, Xu, Xu, Xu, Xu, Xu, Xu, Xu, Xu, Xu
Xu, Xu, Xu, Xu, Xuc, Xuc, Ur, Ur, Ur^Br|, Uu^Uf, Xu, Xuc, Xuc, Ur^Br\, Ur^Br\, Ur^Es, Ur^Br/, Uu^Vud, Ww^Dr, Xu, Wwr^Es, Xu, Wwr^Es, Ww^Dr, Ur^Es, Ur^Dr, Ur^Br/, Uh^Br/, Ur^Edb, Uh, Ur^Es, Ur^Dr, Xu, Xu, Xu, Qlf^Xo, Qlf^Xo, Qlf^Xo, Qlf, Qlf, Ql, Ql, Qlf, Qlf, Cer, Ker, Cer, Xu, Xu, Xu, Xu, Xu, Xu, Xu, Xu, Xu, Xu, Xu, Xu, Xu, Xu, Uu, Uu, Ur, Ur, Ur, Ur, Qlf, Qlf, Qlf, Qlf, Xu, Xu, Xu, Xu, Xu, Xu, Xu, Xu, Xu
Xu, Xu, Xu, Xu, Xuc, Xuc, Ur^Edb, Ur^Edb, Ur^Br|, Uu^Uf, Xu, Xu, Xu, Xuc, Xuc, Ur^Br\, Ur^Es, Ur^Br\, Ur^Br\, Wwr, Wwr, Wwr^Es, Wwr^Es, Ww^Dr, Ww, Wwr, Wwr, Ur^Edb, Ur^Edb, Ur^Edb, Ur^Edb, Uu^Uf, Uh^Em, Xu, Xu, Xu, Xu, Qlf^Xo, Qlf, Qlf, Qlf, Uh^Edb, Ur^Edb, Ur^Edb, Ur, Cer, Ur^Edb, Qxu, Qxu, Ql, Qxu, Qxu, Ql, Xu, Qlf, Xu, Xu, Xu, Xu, Xu, Xu, Xu, Xu, Uu, Qlf, Ur, Ur, Ur, Qlf, Qlf, Qlf, Qlf, Xu, Xu, Xu, Xu, Xu, Xu, Xu, Xu
Xu, Xu, Xu, Xuc, Xuc, Uu, Ur^Edb, Ur^Br/, Uh, Xu, Xu, Xu, Xu, Xu, Xu, Xuc, Xuc, Ur, Xu, Ww, Ww, Wwr^Es, Wwr^Es, Wwr, Wwr, Wwr, Xu, Ur^Eb, Xu, Uu^Vud, Xu, Uh^Dr, Uh^Dr, Xu, Xu, Xu, Xu, Qlf^Xo, Qlf, Qlf, Qlf, Uu^Edb, Ur, Qlf, Ql, Ql, Ql, Ur^Edb, Ur, Qlf, Ql, Ql, Qlf, Qlf, Ur^Edb, Qlf, Qlf, Xu, Xu, Xu, Xu, Xu, Qlf, Qlf, Qlf, Qlf, Uu, Ur, Ur, Qlf, Qlf, Ql, Ql, Xu, Xu, Xu, Xu, Xu, Xu, Xu
Xu, Xu, Xu, Xuc, Uh, Ur^Es, Ur^Br/, Ur^Br|, Xu, Xu, Xu, Xu, Xu, Xu, Xu, Xu, Xu, Xu, Xu, Xu, Wwr, Wwr, Ur^Dr, Xu, Xu, Xu, Xu, Xu, Xu, Xu, Xu, Xu, Xu, Xu, Xu, Xu, Xu, Xu, Xu, Qlf, Ur, Ur, Qlf, Ql, Qxu, Qxu, Qlf, Qlf, Ur, Qlf, Qlf, Ql, Ur, Ur^Edb, Xu, Ur^Edb, Ur, Xu, Xu, Xu, Xu, Xu, Xu, Qlf, Xu, Qlf, Xu, Uu, Ur, Qlf, Qlf, Ql, Qlf, Qlf, Xu, Xu, Xu, Xu, Xu, Xu
Xu, Xu, Xuc, Xuc, Uh, Ur^Es, Ur^Br|, Uu^Vu, Xu, Xu, Xu, Xu, Xu, Xu, Qxu, Xu, Wwr, Ww^Dr, Wwr, Wwr, Ww^Dr, Uu^Dr, Qxu, Qxu, Qxu, Xu, Xu, Xu, Xu, Xu, Ur^Dr, Xu, Xu, Xu, Xos, Xos, Xos, Xu, Uh, Uh, Ur, Qlf, Xu, Xu, Xu, Xu, Xu, Qlf, Qlf, Ur, Qlf, Qlf, Ur, Xu, Xu, Qlf, Xu, Ur, Ur, Xu, Xu, Xu, Xu, Xu, Xu, Xu, Qlf, Xu, Ur, Ur, Uu, Ql, Ql, Ql, Qlf, Xu, Xu, Xu, Xu, Xu
Xuc, Xuc, Uh^Xo, Uh^Xo, Uu^Br/, Ur^Br/, Ur^Edb, Ur^Br\, Ur^Br\, Xu, Xu, Xu, Xu, Xu, Wwr, Ww^Dr, Ww^Es, Wwr, Wwr, Wwr, Xu, Qxu, Qxu, Qxu, Qxu, Xu, Xu, Xu, Xu, Uu^Vud, Ur^Br|, Uh^Dr, Xos, Xos, Cud, Kud, Cud^Dr, Uh^Xo, Uu, Ur^Edb, Ur^Edb, Qlf, Xu, Xu, Xu, Xu, Xu, Qlf, Xu, Ur, Ur, Ur, Xu, Xu, Ql, Xu, Xu, Qlf, Qlf, Ur, Xu, Xu, Xu, Xu, Xu, Xu, Qlf, Ql, Ur, Ur, Uu, Qlf, Ql, Ql, Qlf, Xu, Xu, Xu, Xu, Xu
Uh^Xo, Uh^Xo, Uh^Br/, Uh^Xo, Uh, Uu^Em, Uu^Es, Ur^Edb, Ur^Br|, Xuc, Xu, Xu, Xu, Xu, Wwr, Wwr^Es, Ww^Es, Wwr, Ww, Xu, Xu, Qxu, Qxu, Qxu, Qxu, Qxu, Xu, Xu, Xu, Uh^Es, Uu^Dr, Ur, Ur, Cud, Cud, Cud, Cud^Dr, Uu^Xo, Uu, Ur^Edb, Uh, Xu, Xu, Xu, Xu, Xu, Xu, Xu, Ur, Ur, Xu, Xu, Uh, Uu^Cov, Uu^Cov, Uu^Cov, Uu^Cov, Xu, Xu, Ur^Edb, Ur, Xu, Xu, Xu, Xu, Xu, Xu, Xu, Uh^Xo, Ur, Uu^Xo, Qlf, Ql^Xo, Qlf, Qlf, Xu, Xu, Xu, Xu, Xu
Uh^Br/, Uh^Xo, Uh^Xo, Uh^Xo, Xuc, Uh, Ur^Edb, Ur^Edt, Ur^Br|, Xuc, Xu, Xu, Xu, Xu, Uu^Vu, Ww^Es, Ww^Es, Wwr, Wo, Ww, Ww, Ur^Dr, Xu, Qxu, Uu^Dr, Qxu, Uu^Dr, Xu, Uu^Es, Uu^Dr, Uu^Br|, Ur, Ur, Cud, Cud, Cud, Cud^Dr, Uu^Xo, Uu, Ur, Uh, Xu, Xu, Xu, Xu, Xu, Qlf, Qlf, Ur^Ii, Qlf, Xu, Xu, Uh, Uu^Cov, Uu^Cov, Uu^Kov, Uu^Cov, Ql, Xu, Xu, Ur, Qlf, Qlf, Xu, Xu, Xu, Xu, Xu, Uh^Xo, Ur^Xo, Uu^Xo, Ql^Xo, Ql^Xo, Ql^Xo, Ql^Xo, Xu, Xu, Xu, Xu, Xu
Uh^Xo, Uh^Xo, Xuc, Xuc, Xuc, Uue, Ur^Br\, Ur^Br/, Uu^Br|, Xuc, Xu, Xu, Xu, Xu, Wo, Ww^Es, Wo, Wo, Wo, Wo, Wo, Ww^Dr, Wwr, Uu^Dr, Uu^Dr, Xu, Xu, Xu, Xu, Xu, Uu^Br|, Ur, Xos, Cud, Cud, Cud, Cud^Dr, Uu^Xo, Ur^Edb, Ur, Uu, Xu, Xu, Xu, Xu, Xu, Qlf, Qlf, Qlf, Qlf, Xu, Xu, Xu, Ql, Uu^Cov, Uu^Cov, Uu^Cov, Uu^Cov, Xu, Xu, Ur, Qlf, Qlf, Xu, Xu, Xu, Xu, Xu, Uu^Xo, Ur^Xo, Uu^Xo, Ql^Xo, Qlf^Xo, Ql^Xo, Qlf^Xo, Xu, Xu, Xu, Xu, Xu
Xu, Xuc, Xu, Xu, Xuc, Uue^Edb, Ur^Br\, Ur^Em, Uu^Br|, Xuc, Xu, Xu, Xu, Xu, Xu, Wo, Wo, Wo, Wo, Wo, Wo, Wo, Wo, Ww^Es, Wo, Wwr^Es, Wwr^Es, Uu^Dr, Xu, Uu^Dr, Uu^Dr, Ur, Xu, Xos, Xos, Kud, Xos, Uh^Xo, Uh, Ur, Uu^Edb, Xu, Xu, Xu, Xu, Xu, Ql, Qlf, Qlf, Qlf, Qlf, Xu, Qlf, Xu, Ur^Edb, Uu^Cov, Xu, Xu, Xu, Qlf, Qlf, Ur, Qlf, Xu, Xu, Xu, Xu, Xu, Qlf, Ur^Xo, Uu, Qlf^Xo, Qlf^Xo, Ql^Xo, Qlf^Xo, Xu, Xu, Xu, Xu, Xu
Xu, Xu, Xu, Xu, Xuc, Uu^Dr, Ur^Edb, Ur^Br\, Ur^Br|, Xuc, Xu, Xu, Xu, Xu, Xu, Wo, Wo, Wo, Wo, Wo, Wo, Wo, Wo, Wo, Xu, Ww^Es, Xu, Xu, Xuc, Xuc, Ur^Br|, Uu^Vud, Xuc, Xu, Xu, Xos, Xu, Xu, Ql, Ur, Uu, Xu, Xu, Xu, Xu, Xu, Ql, Qlf, Qlf, Qlf, Qlf, Qlf, Qlf, Qlf, Ur^Edb, Ur^Edb, Qlf, Qlf, Qlf, Qlf, Ur, Ur, Xu, Xu, Xu, Xu, Qlf, Ql, Qlf, Ur, Ql, Qlf, Ql, Ql, Ql, Xu, Xu, Xu, Xu, Xu
Xu, Xu, Xu, Xu, Xu, Xuc, Uu, Ur, Ur^Br|, Xuc, Xu, Xu, Xu, Xu, Xu, Xu, Xu, Wo, Wo, Wo, Uu^Dr, Ur^Br\, Ur^Br\, Xuc, Xuc, Xu, Xu, Xuc, Uu^Dr, Uu, Ur^Br|, Ur^Dr, Ur, Uu^Vu, Uu^Dr, Xu, Xu, Ql, Ql, Ur, Uu, Xu, Xu, Xu, Xu, Xu, Xu, Ql, Qlf, Qlf, Ql, Qlf, Qlf, Qlf, Ur, Ur, Qlf, Qlf, Ur, Ur^Edb, Qlf, Xu, Xu, Xu, Xu, Xu, Xu, Xu, Uu, Ur, Qlf, Qlf, Qlf, Ql, Qlf, Qlf, Xu, Xu, Xu, Xu
Xu, Xu, Xu, Xu, Xu, Xuc, Uu, Ur^Es, Ur^Br|, Xuc, Xuc, Xu, Xu, Xu, Xu, Xu, Xu, Xu, Wo^Xo, Wo^Xo, Xuc, Uu, Ur^Br|, Uu^Dr, Uu, Xuc, Xu, Xu, Xuc, Uu, Ur^Br|, Xuc, Xuc, Uu^Es, Xu, Xu, Xu, Ql, Ql, Ur, Ur, Uh, Xu, Xu, Xu, Xu, Xu, Qlf, Qlf, Ql, Qxu, Ql, Xu, Xu, Ur^Edb, Ur, Xu, Xu, Ur, Qlf, Qlf, Xu, Xu, Xu, Xu, Xu, Xu, Uu, Ur, Ur, Ql, Ql, Ql, Ql, Ql, Ql, Qlf, Xu, Xu, Xu
Xu, Xu, Xu, Xu, Xu, Xuc, Uu^Uf, Ur^Edb, Ur^Br|, Uu^Vu, Xuc, Xuc, Xuc, Xu, Xu, Xu, Xu, Xu, Wo^Xo, Wo^Xo, Xu, Xuc, Ur^Dr, Ur^Br\, Ur^Br\, Xuc, Uu^Edb, Xuc, Xuc, Uu^Dr, Uu^Br|, Ur, Xuc, Xuc, Xuc, Xu, Xu, Xu, Ql, Ql, Ur, Uu, Uu^Edb, Xu, Xu, Xu, Qlf, Qlf, Qlf, Xu, Xu, Qxu, Uh, Ur^Edb, Ur^Edb, Ur^Edb, Ur^Edb, Ur^Edb, Ql, Qlf, Qlf, Qlf, Xu, Xu, Xu, Xu, Qlf, Ur, Ur, Uu^Dr, Qlf, Ql, Qlf^Cov, Qlf^Cov, Qlf^Cov, Ql, Qlf, Xu, Xu, Xu
Xu, Xu, Xu, Xu, Xu, Xuc, Uh, Ur^Edb, Ur^Edb, Ur^Br\, Ur^Br\, Uu^Em, Uu^Es, Xuc, Xuc, Xu, Xu, Xu, Xu, Wo^Xo, Xu, Xuc, Xuc, Ur, Xuc, Ur^Br|, Xuc, Uu^Dr, Xu, Xuc, Ur^Br/, Ur^Dr, Ur, Xuc, Xuc, Xu, Xu, Xu, Xu, Ql, Ql, Ur^Edb, Ur, Uh, Uh, Xu, Qlf, Qlf, Qlf, Xu, Xu, Xu, Ker, Ur^Edb, Ur^Edb, Ur^Edb, Ker, Qxu, Qxu, Ql, Qlf, Qlf, Xu, Xu, Uh, Qlf, Ur, Ur, Uu, Qlf, Qlf, Ql, Qlf^Cov, Qlf^Kov, Qlf^Cov, Ql, Ql, Ql, Xu, Xu
Xu, Xu, Xu, Xu, Xu, Xuc, Xuc, Uue^Esd, Uu^Edb, Ur^Em, Ur, Ur^Br\, Ur^Br\, Uue, Uue^Em, Xuc, Xuc, Xu, Xu, Wo^Xo, Wo^Xo, Xu, Xuc, Xuc, Xuc, Ur^Br|, Xuc, Xuc, Xu, Ur, Ur, Xuc, Ur, Ur, Xuc, Xu, Xu, Xu, Xu, Ql, Ql, Ur, Ur^Edb, Ur, Ur, Qlf, Qlf, Qlf, Qlf, Xu, Qxu, Qxu, Qxu, Cer, Ur^Edb, Cer, Qxu, Qxu, Qxu, Ql, Qlf, Qlf, Xu, Xu, Uu, Uu, Ur, Uu, Qlf, Ql, Ql, Ql, Ql, Qlf^Cov, Ql, Ql, Qlf, Qlf, Xu, Xu
Xu, Xu, Xu, Xu, Xu, Xu, Xu, Xuc, Xuc, Uu^Em, Uu, Ur, Ur, Ur^Br\, Ur^Br|, Xuc, Xuc, Xu, Xu, Xu, Wo^Xo, Xuc, Xuc, Uu^Dr, Uu^Edb, Ur^Br|, Ur^Br\, Uh^Br/, Xuc, Uu, Xuc, Xuc, Xuc, Uu^Es, Uh, Xuc, Xuc, Xu, Xu, Xu, Xu, Xu, Uh, Ur^Edb, Ur, Ur, Qlf, Qlf, Qlf, Xu, Xu, Qxu, Qxu, Cer, Ur, Cer, Qxu, Qxu, Ql, Ql, Xu, Xu, Qlf, Xu, Ur, Ur^Edb, Uu, Uu, Qlf, Qlf, Ql, Ql, Qlf, Ql, Qlf, Ql, Ql, Ql, Xu, Xu
Xu, Xu, Xu, Xu, Xu, Xu, Xu, Xu, Xu, Xuc, Xuc, Uu, Uu^Edb, Ur^Edb, Ur^Br|, Uu^Uf, Xuc, Xu, Xu, Xu, Wo^Xo, Xuc, Xuc, Xuc, Ur, Ur, Xuc, Uu^Br\, Xuc, Uu^Dr, Xuc, Xuc, Xuc, Ur, Ur, Uu, Ur, Xuc, Xu, Xu, Xu, Xu, Xu, Uh, Uu, Ur, Ur, Ql, Ur, Xu, Xu, Xu, Qxu, Cer, Ur, Cer, Qxu, Qxu, Qxu, Xu, Qlf, Qlf, Ur^Edb, Ur, Uh, Qlf, Ql, Ql, Ql, Ql, Ql, Qlf, Xu, Ql, Ql, Qlf, Qlf, Qlf, Xu, Xu
Xu, Xu, Xu, Xu, Xu, Xu, Xu, Xu, Xu, Xu, Xuc, Xuc, Uu^Vu, Ur^Edb, Ur^Br|, Uu^Uf, Xuc, Xu, Xu, Xu, Xu, Wo^Xo, Wo^Xo, Xuc, Uu^Es, Xuc, Xuc, Ur^Br|, Ur, Xuc, Xuc, Xuc, Ur, Uu^Dr, Ur, Ur, Xuc, Uu^Dr, Xuc, Xu, Xu, Xu, Xu, Xu, Xu, Uu, Cer, Ur, Ur, Ur, Ur^Edb, Ur^Edb, Ur^Edb, Ur, Ur^Edb, Ur^Edb, Ur^Edb, Qxu, Ur^Edb, Qlf, Ur, Ur, Uh, Uh, Uh, Qlf, Ql, Qlf, Ql, Qlf, Ql, Qlf, Xu, Xu, Ql, Ql, Ql^Xo, Qlf^Xo, Xu, Xu
Xu, Xu, Xu, Xu, Xu, Xu, Xu, Xu, Xu, Xu, Xuc, Xuc, Uu, Ur, Ur^Br|, Uu, Xuc, Xu, Xuc, Xuc, Xu, Xu, Xu, Wo^Xo, Xuc, Xuc, Xuc, Ur^Br\, Ur^Dr, Xuc, Xuc, Xuc, Ur, Xuc, Xuc, Xuc, Xuc, Uu, Xuc, Xu, Xu, Xu, Xu, Xu, Xu, Xu, Xu, Cer^Edb, Cer, Ur^Edb, Ur^Edb, Ur, Ur^Edb, Ur^Edb, Ur^Edb, Ur^Edb, Ur^Edt, Ur^Edb, Ur^Edb, Ur^Edb, Ur, Uh, Cer, Cer, Xu, Xu, Xu, Qlf, Ql, Qlf, Xu, Xu, Xu, Xu, Xu, Qlf^Xo, Ql^Xo, Qlf^Xo, Xu, Xu
Xu, Xu, Xu, Xu, Xu, Xu, Xu, Xu, Xu, Xu, Xuc, Uu^Uf, Ur^Dr, Ur^Edb, Ur, Uu^Br\, Uu^Br\, Xuc, Uue^Esd, Xuc, Xuc, Xu, Xu, Wo^Xo, Wo^Xo, Xuc, Xuc, Xuc, Ur, Ur^Br\, Ur^Br\, Uu^Vu, Ur, Uu^Edb, Wwr, Xuc, Xuc, Uu^Dr, Uu, Xuc, Xuc, Xu, Xu, Xu, Xu, Xu, Xu, Xu, Xu, Ker, Cer^Edb, Ur^Edb, Ur^Edb, Ur^Edb, Ur^Edb, Ur^Edb, Ur^Edb, Ur^Edb, Ur, Ur, Ker, Cer, Xu, Xu, Xu, Xu, Xu, Ql, Qlf, Ql, Xu, Xu, Xu, Xu, Xu, Qlf^Xo, Ql^Xo, Qlf^Xo, Xu, Xu
Xu, Xu, Xu, Xu, Xu, Xu, Xu, Xu, Xos, Xos, Xos, Xos, Ur^Edb, Ur^Edb, Uu, Uu^Dr, Uu, Uu^Br\, Uu^Br\, Uue, Uu^Em, Xuc, Xuc, Xu, Xu, Wo^Xo, Wo^Xo, Uu^Es, Xuc, Uu, Xuc, Uu^Br\, Ur^Br\, Xuc, Wwr^Dr, Wwr, Wwr, Xuc, Xuc, Xuc, Xuc, Xuc, Xuc, Xu, Xu, Xu, Xu, Xu, Xu, Xu, Qlf, Uh, Cer, Ur^Edb, Ur^Edb, Ur, Cer, Uh, Ql, Cer, Xu, Xu, Xu, Xu, Xu, Xu, Qlf, Ql, Qlf, Qlf, Xu, Xu, Xu, Xu, Xu, Ql^Xo, Qlf, Ql, Qlf, Xu
Xu, Xu, Xu, Xu, Xu, Xu, Xos, Xos, Cud, Cud, Cud, Ur, Ur, Ur, Xos, Xuc, Xuc, Uue^Edt, Uue^Edt, Uu^Br\, Uu^Br\, Uue^Edt, Uue^Edt, Xuc, Xuc, Xu, Xu, Wo^Xo, Wo^Xo, Xuc, Xuc, Xuc, Wo^Dr, Xuc, Wo^Ii, Wwr^Dr, Ai^Ii, Xu, Xu, Xuc, Xu, Xu, Xuc, Xu, Xu, Xu, Xu, Xu, Xu, Xu, Xu, Qlf, Cer, Cer, Cer^Edb, Cer, Cer, Ql, Ql, Ql, Xu, Xu, Qlf, Xu, Ql, Qlf, Ql, Ql, Qlf, Xu, Xu, Xu, Xu, Xu, Xu, Qlf, Qlf, Ql, Ql, Xu
Xu, Xu, Xu, Xu, Xu, Xu, Xos, Cud, Cud, Cud, Cud, Ur^Dr, Ur, Uu^Eb, Xos, Xu, Xu, Xuc, Uue, Uu^Br|, Uu^Br\, Uu^Br\, Uu^Br|, Uue^Edt, Xuc, Xu, Xu, Xuc, Xuc, Wo^Xo, Wo^Xo, Xuc, Wo^Ii, Wo^Ii, Wo^Ii, Wo^Ii, Wo^Ii, Ai^Ii, Ai^Ii, Xu, Ha, Xu, Ha, Xu, Xu, Xu, Xu, Xu, Xu, Xu, Xu, Xu, Cer, Cer^Edb, Ker, Cer, Cer^Edb, Xu, Ql, Ql, Ql, Ql, Qlf, Qlf, Qlf, Ql, Ql, Qlf, Qlf, Qlf, Xu, Xu, Xu, Xu, Xu, Xu, Qlf, Ql, Ql, Xu
Xos, Xos, Xu, Xu, Xu, Xu, Xos, Cud, Kud, Cud, Ur^Edb, Ur^Edb, Cud, Cud, Cud, Xos, Xu, Xuc, Uue^Edt, Uu^Edt, Uu^Edt, Uu^Br\, Uu^Br|, Uu^Dr, Xuc, Xu, Xu, Xu, Xuc, Xuc, Xuc, Wo^Xo, Xu, Ai, Ai, Ai, Ha, Wo, Wo^Xo, Ms^Xo, Ms^Xm, Ms^Xm, Ms^Xm, Ha, Ms, Xu, Ha, Xu, Xu, Xu, Xu, Xu, Xu, Cer, Cer, Cer, Xu, Xu, Xu, Ql, Qlf, Ql, Qlf, Qlf, Xu, Qlf, Xu, Qlf, Xu, Qlf, Xu, Xu, Xu, Xu, Xu, Xu, Xu, Qlf, Qlf, Xu
Uh^Xo, Uh^Xo, Xu, Xos, Xu, Xu, Xu, Xos, Xos, Cud, Ur, Ur, Cud, Cud, Cud, Xos, Xu, Xuc, Xuc, Uu^Dr, Uu^Edt, Uu^Edb, Uu^Br/, Uue^Edt, Xuc, Xu, Xu, Xu, Xuc, Xuc, Xuc, Xuc, Xu, Xu, Ai^Xo, Ha, Ms^Xo, Ha^Xo, Wo^Xo, Wo^Xo, Ms^Xm, Ms^Xm, Ms^Xm, Ms^Xm, Ms, Ms^Xm, Ms^Xm, Ha, Xu, Xu, Xu, Xu, Xu, Xu, Xu, Xu, Xu, Xu, Xu, Xu, Xu, Qlf, Xu, Xu, Xu, Xu, Xu, Xu, Xu, Xu, Xu, Xu, Xu, Xu, Xu, Xu, Xu, Qlf, Qlf, Qlf
Uu^Xo, Uu^Xo, Xu, Uu^Dr, Uu^Xo, Xos, Uu^Xo, Uu^Em, Ur^Dr, Ur, Ur^Dr, Cud, Kud, Cud, Cud, Xos, Xu, Xu, Xuc, Uue^Esd, Uue^Edt, Uue^Esd, Xuc, Xuc, Xu, Xu, Xu, Xu, Xu, Xuc, Xuc, Xuc, Xu, Xu, Ms^Xm, Ha^Xo, Ha, Ms^Xm, Ms, Wo^Xo, Wo^Xo, Ms^Xm, Ms^Xm, Ms^Xm, Ms^Xm, Ms, Ms^Xm, Ms, Xu, Xu, Xu, Xu, Xu, Xu, Xu, Xu, Xu, Xu, Xu, Xu, Xu, Xu, Xu, Xu, Xu, Xu, Xu, Xu, Xu, Xu, Xu, Xu, Xu, Xu, Xu, Xu, Xu, Qlf, Qlf, Qlf
Xos, Uh^Xo, Uh^Xo, Xu, Uu^Dr, Uh^Xo, Uu^Xo, Uu, Ur^Dr, Ur^Es, Ur^Es, Xos, Xos, Cud, Xos, Xos, Xu, Xu, Xu, Xuc, Xuc, Xuc, Xu, Xu, Xu, Xu, Xu, Xu, Xu, Xu, Xu, Xu, Xu, Xu, Ms^Xm, Ha, Ha, Ms, Ms, Ms, Ms, Wo^Xo, Ms^Xm, Ms^Xm, Ms, Ha, Ms, Ms, Ms, Ms, Ms, Xu, Xu, Xu, Xu, Xu, Xu, Xu, Xu, Xu, Xu, Xu, Xu, Xu, Xu, Xu, Xu, Xu, Xu, Xu, Xu, Xu, Xu, Xu, Xu, Xu, Xu, Qlf, Qlf, Qlf
Xu, Xos, Xuc, Xuc, Xuc, Xos, Xuc, Xos, Xos, Ur, Ur^Dr, Ur, Ur, Ur, Uu^Dr, Ur, Ur, Xuc, Ur, Xu, Xu, Xu, Xu, Xu, Xu, Xu, Xu, Xu, Xu, Xu, Xu, Xu, Xu, Ms^Xm, Xu, Ms^Xm, Ms^Xm, Ms, Ms^Xm, Ms^Xm, Ms^Xm, Ms^Xm, Ms^Xm, Ms^Xm, Ms^Xm, Ms, Ms^Xm, Ms, Ms, Ms, Ms, Ms, Ms, Xu, Xu, Xu, Xu, Xu, Xu, Xu, Xu, Xu, Xu, Xu, Xu, Xu, Xu, Xu, Xu, Xu, Xu, Xu, Xu, Xu, Xu, Xu, Xu, Xu, Qlf, Qlf
Xuc, Xuc, Xuc, Xuc, Xuc, Xuc, Xuc, Xuc, Xuc, Xos, Xos, Ur, Ur, Ur, Ur, Uh^Em, Ur, Ur, Xuc, Ur, Ur, Xu, Uh^Em, Xu, Xu, Xu, Xu, Xu, Xu, Xu, Xu, Xu, Xu, Xu, Xu, Xu, Xu, Ms^Xm, Xu, Ms, Ms, Ms^Xm, Ms^Xm, Ms^Xm, Ms^Xm, Ms^Xm, Ms^Xm, Ms^Xm, Ms^Xm, Ms, Xu, Ms, Xu, Xu, Xu, Xu, Xu, Xu, Xu, Xu, Xu, Xu, Xu, Xu, Xu, Xu, Xu, Xu, Xu, Xu, Xu, Xu, Xu, Xu, Xu, Xu, Xu, Xu, Xu, Xu
Xuc, Xuc, Xuc, Xuc, Xuc, Xuc, Uu, Uh, Xuc, Xuc, Xuc, Xuc, Xuc, Ur, Xuc, Uu, Xuc, Xuc, Uu, Xuc, Ur^Dr, Uh, Uu^Dr, Xu, Xu, Xu, Xu, Xu, Xu, Xu, Xu, Xu, Xu, Xu, Xu, Xu, Xu, Xu, Xu, Xu, Xu, Xu, Xu, Xu, Xu, Xu, Xu, Xu, Xu, Xu, Xu, Xu, Xu, Xu, Xu, Xu, Xu, Xu, Xu, Xu, Xu, Xu, Xu, Xu, Xu, Xu, Xu, Xu, Xu, Xu, Xu, Xu, Xu, Xu, Xu, Xu, Xu, Xu, Xu, Xu
Xuc, Xuc, Xuc, Xuc, Xuc, Uu^Es, Ur, Xuc, Xuc, Ww^Dr, Ww, Xuc, Xuc, Xuc, Xuc, Xuc, Ur, Ur, Xuc, Uh, Ur, Xuc, Xuc, Xuc, Xuc, Xu, Xu, Xu, Xu, Xu, Xu, Xu, Xu, Xu, Xu, Xu, Xu, Xu, Xu, Xu, Xu, Xu, Xu, Xu, Xu, Xu, Xu, Xu, Xu, Xu, Xu, Xu, Xu, Xu, Xu, Xu, Xu, Xu, Xu, Xu, Xu, Xu, Xu, Xu, Xu, Xu, Xu, Xu, Xu, Xu, Xu, Xu, Xu, Xu, Xu, Xu, Xu, Xu, Xu, Xu
Xu, Xuc, Xuc, Xuc, Xuc, Xuc, Xuc, Ur, Ur, Uu^Dr, Wwrt, Ww^Es, Ww, Ww^Dr, Ww^Es, Uh, Ur, Ur, Ur, Ur^Es, Uh, Uh, Ur, Uu^Em, Uu, Uu^Dr, Uh, Xu, Xu, Xu, Xu, Xu, Xu, Xu, Xu, Xu, Xu, Xu, Xu, Xu, Xu, Xu, Xu, Xu, Xu, Xu, Xu, Xu, Xu, Xu, Xu, Xu, Xu, Xu, Xu, Xu, Xu, Xu, Xu, Xu, Xu, Xu, Xu, Xu, Xu, Xu, Xu, Xu, Xu, Xu, Xu, Xu, Xu, Xu, Xu, Xu, Xu, Xu, Xu, Xu
Xu, Xu, Xue, Uu^Dr, Uu, Ur, Ur, Ur, Uh, Ur, Ur, Uh, Uu^Dr, Ww, Ur, Ur, Xuc, Xuc, Ur, Ur, Xuc, Ur, Ur, Xuc, Xuc, Xuc, Xuc, Xu, Xu, Xu, Xu, Xu, Xu, Xu, Xu, Xu, Xu, Xu, Xu, Xu, Xu, Xu, Xu, Xu, Xu, Xu, Xu, Xu, Xu, Xu, Xu, Xu, Xu, Xu, Xu, Xu, Xu, Xu, Xu, Xu, Xu, Xu, Xu, Xu, Xu, Xu, Xu, Xu, Xu, Xu, Xu, Xu, Xu, Xu, Xu, Xu, Xu, Xu, Xu, Xu
Xu, Xu, Xuc, Uh, Xuc, Uu^Em, Xuc, Uh, Xuc, Uh, Ur^Es, Uu^Em, Ur, Ur, Ur, Ur, Xuc, Ur, Ur, Xuc, Xuc, Xuc, Uu, Xuc, Xuc, Xuc, Xuc, Xuc, Xu, Xu, Xu, Xu, Xu, Xu, Xu, Xu, Xu, Xu, Xu, Xu, Xu, Xu, Xu, Xu, Xu, Xu, Xu, Xu, Xu, Xu, Xu, Xu, Xu, Xu, Xu, Xu, Xu, Xu, Xu, Xu, Xu, Xu, Xu, Xu, Xu, Xu, Xu, Xu, Xu, Xu, Xu, Xu, Xu, Xu, Xu, Xu, Xu, Xu, Xu, Xu
Xuc, Xuc, Xuc, Xuc, Xuc, Uh, Xuc, Xuc, Xuc, Ur^Dr, Ur^Es, Ur^Es, Xuc, Ur^Es, Xuc, Xuc, Xuc, Xuc, Xuc, Uh, Xuc, Xuc, Xuc, Uh, Xuc, Xuc, Xuc, Xuc, Xu, Xu, Xu, Xu, Xu, Xu, Xu, Xu, Xu, Xu, Xu, Xu, Xu, Xu, Xu, Xu, Xu, Xu, Xu, Xu, Xu, Xu, Xu, Xu, Xu, Xu, Xu, Xu, Xu, Xu, Xu, Xu, Xu, Xu, Xu, Xu, Xu, Xu, Xu, Xu, Xu, Xu, Xu, Xu, Xu, Xu, Xu, Xu, Xu, Xu, Xu, Xu
Xuc, Xuc, Xuc, Xuc, Xuc, Xuc, Xuc, Xuc, Xuc, Ur^Es, Ur, Ur^Dr, Xuc, Xuc, Xuc, Xuc, Xuc, Xuc, Xuc, Xuc, Xuc, Xuc, Xuc, Xuc, Xuc, Xuc, Xuc, Xuc, Xu, Xu, Xu, Xu, Xu, Xu, Xu, Xu, Xu, Xu, Xu, Xu, Xu, Xu, Xu, Xu, Xu, Xu, Xu, Xu, Xu, Xu, Xu, Xu, Xu, Xu, Xu, Xu, Xu, Xu, Xu, Xu, Xu, Xu, Xu, Xu, Xu, Xu, Xu, Xu, Xu, Xu, Xu, Xu, Xu, Xu, Xu, Xu, Xu, Xu, Xu, Xu
Xuc, Xuc, Xuc, Xuc, Xuc, Xuc, Xuc, Xuc, Xuc, 1 Ur^Es, Ur^Ii, 2 Ur^Es, Xuc, Xuc, Xuc, Xuc, Xuc, Xuc, Xuc, Xuc, Xuc, Xuc, Xuc, Xuc, Xuc, Xuc, Xuc, Xuc, Xu, Xu, Xu, Xu, Xu, Xu, Xu, Xu, Xu, Xu, Xu, Xu, Xu, Xu, Xu, Xu, Xu, Xu, Xu, Xu, Xu, Xu, Xu, Xu, Xu, Xu, Xu, Xu, Xu, Xu, Xu, Xu, Xu, Xu, Xu, Xu, Xu, Xu, Xu, Xu, Xu, Xu, Xu, Xu, Xu, Xu, Xu, Xu, Xu, Xu, Xu, Xu
Xuc, Xuc, Xuc, Xuc, Xuc, Xuc, Xuc, Xuc, Xuc, Xuc, Xuc, Xuc, Xuc, Xuc, Xuc, Xuc, Xuc, Xuc, Xuc, Xuc, Xuc, Xuc, Xuc, Xuc, Xuc, Xuc, Xu, Xu, Xu, Xu, Xu, Xu, Xu, Xu, Xu, Xu, Xu, Xu, Xu, Xu, Xu, Xu, Xu, Xu, Xu, Xu, Xu, Xu, Xu, Xu, Xu, Xu, Xu, Xu, Xu, Xu, Xu, Xu, Xu, Xu, Xu, Xu, Xu, Xu, Xu, Xu, Xu, Xu, Xu, Xu, Xu, Xu, Xu, Xu, Xu, Xu, Xu, Xu, Xu, Xu
Xu, Xuc, Xuc, Xuc, Xuc, Xuc, Xuc, Xuc, Xuc, Xuc, Xuc, Xuc, Xu, Xuc, Xuc, Xuc, Xuc, Xuc, Xuc, Xuc, Xuc, Xuc, Xuc, Xuc, Xuc, Xu, Xu, Xu, Xu, Xu, Xu, Xu, Xu, Xu, Xu, Xu, Xu, Xu, Xu, Xu, Xu, Xu, Xu, Xu, Xu, Xu, Xu, Xu, Xu, Xu, Xu, Xu, Xu, Xu, Xu, Xu, Xu, Xu, Xu, Xu, Xu, Xu, Xu, Xu, Xu, Xu, Xu, Xu, Xu, Xu, Xu, Xu, Xu, Xu, Xu, Xu, Xu, Xu, Xu, Xu
Xu, Xu, Xu, Xuc, Xuc, Xuc, Xuc, Xuc, Xuc, Xuc, Xu, Xu, Xu, Xu, Xu, Xuc, Xu, Xuc, Xuc, Xuc, Xuc, Xuc, Xuc, Xuc, Xu, Xu, Xu, Xu, Xu, Xu, Xu, Xu, Xu, Xu, Xu, Xu, Xu, Xu, Xu, Xu, Xu, Xu, Xu, Xu, Xu, Xu, Xu, Xu, Xu, Xu, Xu, Xu, Xu, Xu, Xu, Xu, Xu, Xu, Xu, Xu, Xu, Xu, Xu, Xu, Xu, Xu, Xu, Xu, Xu, Xu, Xu, Xu, Xu, Xu, Xu, Xu, Xu, Xu, Xu, Xu
Xu, Xu, Xu, Xu, Xu, Xuc, Xu, Xu, Xu, Xu, Xu, Xu, Xu, Xu, Xu, Xu, Xu, Xu, Xu, Xu, Xu, Xu, Xu, Xu, Xu, Xu, Xu, Xu, Xu, Xu, Xu, Xu, Xu, Xu, Xu, Xu, Xu, Xu, Xu, Xu, Xu, Xu, Xu, Xu, Xu, Xu, Xu, Xu, Xu, Xu, Xu, Xu, Xu, Xu, Xu, Xu, Xu, Xu, Xu, Xu, Xu, Xu, Xu, Xu, Xu, Xu, Xu, Xu, Xu, Xu, Xu, Xu, Xu, Xu, Xu, Xu, Xu, Xu, Xu, Xu
