Ms^Xm, Ms^Xm, Ms^Xm, Ms^Xm, Ms^Xm, Ms^Xm, Ms^Xm, Ms^Xm, Ms^Xm, Ms^Xm, Ms, Ms^Xm, Ms^Xm, Ms^Xm, Ms^Xm, Ha, Ha, Ha, Ms^Xm, Gg, Ms^Xm, Ai, Ai, Ai, Ai, Ai, Ai, Ai, Ai, Ha, Ha, Ha, Aa^Fpa, Aa^Fma, Hh, Aa^Fma, Aa^Fpa, Aa^Fpa, Hh, Hh, Gll^Fdw, Gll, Gll^Fdw, Gs, Re, Gs
Ms^Xm, Ms^Xm, Ms^Xm, Ms^Xm, Ms^Xm, Ms^Xm, Ms, Ms, Ms^Xm, Ms, Cea, Cea, Cea, Cea, Ha, Aa^Fpa, Ha, Ha, Ha, Ms^Xm, Ha, Ha, Ha, Ai, Ha, Ai, Ha, Ai, Ha, Ha, Ms, Ha, Aa^Fma, Aa^Fpa, Aa^Fpa, Aa, Gll^Fdw, Aa, Hh, Hh, Gll^Fdw, Gll, Gll^Fmw, Gll^Fmw, Re, Gll^Fp
Ms^Xm, Ms^Xm, Ms^Xm, Ms^Xm, Ms, Ms^Xm, Cea, Ms, Cea, Re, Re, Kea, Cea, Cea, Aa, Aa, Aa^Fpa, Aa^Fma, Ai, Ha, Ww, Aa^Fma, Ha, Ha, Ha, Ms, Ms^Xm, Ha, Aa^Fma, Hh, Aa^Fpa, Aa, Hh, Aa^Fma, Gll^Fmw, Aa^Fma, Gll^Fmw, Aa, Aa, Gll, Gll^Fdw, Gll^Fdw, Gll^Fmw, Re, Gll^Fmw, Aa
Ms^Xm, Ms^Xm, Ms, Ms, Ha, Ha, Aa^Fpa, Cea, Kea, Cea, Aa^Fma, Re, Re, Aa^Fpa, Aa^Vca, Aa^Fpa, Aa^Fma, Aa^Fma, Aa^Fma, Ww, Aa^Fma, Aa^Fma, Ms, Aa^Fma, Ms^Xm, Ms, Ms, Aa^Fma, Hh, Ha, Aa^Fma, Aa^Fma, Gd^Fetd, Gll, Gll, Gll, Aa, Gll, Gll^Fdw, Gll^Fmw, Gll, Gll, Gll, Re, Re, Gll
Ms, Ms^Xm, Ms, Ha, Aa, Aa^Fpa, Ai, Ms, Cea, Cea, Ms^Xm, Aa^Fma, Aa^Fma, Re, Re, Aa^Fma, Aa^Fma, Aa^Fpa, Aa^Fma, Aa^Fpa, Aa^Fpa, Aa^Fpa, Aa^Fpa, Aa^Fma, Ww, Ms, Aa, Hh, Hh, Hh, Hh, Gll^Fdw, Aa, Gll, Gll^Fp, Gll^Fp, Aa, Hh^Vhh, Ss, Gll^Fp, Gll, Gll^Fmw, Gll, Re, Hh, Gs
Ms, Ms, Ms, Ha, Aa^Fma, Ai, Ms, Ms, Ms, Ms, Aa^Fpa, Aa, Aa^Fma, Re, Re, Ha, Ha, Ha, Ms^Xm, Aa^Fpa, Aa^Fpa, Aa, Aa^Fma, Ha^Vhha, Ai, Ms^Xm, Ms^Xm, Hh, Ss, Gd, Gll^Fp, Gll^Fp, Gll^Fp, Gll^Fp, Gll^Fp, Gll, Gll^Fp, Gll^Fp, Ww, Ww, Gd, Gll^Fdw, Hh, Re, Hh, Gs
Ha, Ms, Ms^Xm, Ha, Ai, Ai, Aa^Fma, Ms, Aa^Fpa, Aa^Fpa, Ww, Aa^Fpa, Aa^Vla, Re, Re, Ha, Ha, Ha, Ms, Aa^Fma, Aa^Fma, Aa^Fpa, Aa^Fma, Ww, Gll^Fp, Ms, Gll^Fdw, Hh, Ss, Aa, Gll^Fdw, Gll^Fp, Gll^Fp, Gll^Fp, Gll^Fp, Gll^Fp, Gll^Fp, Gll^Fp, Gd, Gll, Aa, Aa, Gll^Fp, Re, Re, Gs
Ha, Ms^Xm, Aa^Fpa, Aa, Ai, Ai, Aa^Fma, Aa^Fpa, Aa^Fma, Aa^Fpa, Aa^Fma, Aa^Fma, Ms, Ha, Aa^Fma, Re, Ms^Xm, Ms, Ms, Ai, Ms, Aa^Fma, Hh, Gll^Fp, Gll^Fp, Gll^Fp, Hh, Hh, Ss, Aa, Aa, Gll^Fmw, Gll^Fp, Gll^Fp, Gll^Fmw, Gll^Fp, Gd, Gll, Gll^Fmw, Aa, Aa, Gll^Fp, Gll^Fp, Gll^Fp, Re, Gll^Fp
Ha, Ha, Ms, Aa, Ai, Ai, Ai, Aa^Fma, Ww, Ai, Ms, Ms, Ms, Ms, Ms, Re, Re, Ms, Aa^Fma, Ww, Ww, Ms^Xm, Aa^Fma, Gll^Fp, Gll^Fp, Hh, Gll^Fp, Ss, Gll^Fmw, Gll^Fmw, Gll^Fp, Gll^Fp, Hh, Gd, Ww, Gd, Gll^Fmw, Gll^Fp, Gll^Fp, Gll^Fmw, Gll^Fp, Gll^Fmw, Gs, Aa, Re, Gll^Fp
Ha, Ms, Ms, Aa^Fma, Aa^Fma, Ai, Aa^Fma, Aa^Fma, Gll, Ww, Hh, Ms, Ms, Ms, Ha, Aa^Fma, Re, Aa^Fma, Aa, Aa^Fma, Ms, Ms, Ms^Xm, Aa^Fma, Gll^Fdw, Gll^Fp, Gll^Fdw, Gll^Fmw, Gll^Fp, Gll^Fp, Hh, Hh, Gll, Ww, Ww, Ww, Ww, Gll^Fp, Ce, Ce, Cea, Aa, Gll^Fp, Gs^Es, Re, Ss
Ha, Ha, Ms, Ms^Xm, Ms^Xm, Ms^Xm, Aa^Fma, Ha^Vhha, Gll, Hh, Hh, Ms^Xm, Ms^Xm, Ha, Aa^Fma, Hh, Gll, Re, Re, Hh, Ms, Ms^Xm, Hh, Aa^Fma, Gd, Gll^Fp, Gll^Fdw, Gll^Fmw, Gll^Fmw, Aa, Gll, Gll^Fp, Gll^Fp, Gll^Fp, Gll^Fp, Gll^Fmw, Gll^Fmw, Gll^Fp, Ce, Kea, Ce, Gll^Fp, Re, Re, Ss, Ww
Ha, Ha, Aa^Fma, Ms, Ha, Ms, Ms, Gll, Ms^Xm, Ww, Ww, Ms^Xm, Aa^Fma, Aa^Fma, Hh, Hh, Hh, Hh, Re, Aa^Fma, Aa^Fma, Aa^Fma, Aa^Fma, Aa^Fma, Gd, Gd, Aa, Gll^Fdw, Gd, Gd, Hh, Gll^Fp, Gll^Fp, Aa, Aa^Vca, Aa, Gll^Fmw, Gll^Fmw, Gll^Fp, Ce, Gll^Fp, Re, Gs, Ss, Ww, Ww
Aa^Fpa, Aa^Fpa, Ha, Aa^Fma, Gll, Gll, Gll, Ms, Aa^Fma, Aa^Fma, Hh, Aa^Fma, Gll^Fmw, Gll^Fmw, Aa, Aa, Hh, Hh, Gll, Re, Gll^Fp, Gll^Fmw, Gll^Fp, Gll^Fp, Aa, Aa, Aa, Gll, Gll, Gd, Gs, Gs, Gs, Aa, Gll^Fmw, Aa, Ww, Ww, Ss, Re^Vct, Re, Re, Re^Vct, Ss, Ce, Ww
Aa^Fma, Aa^Fpa, Gll^Fmw, Hh, Aa^Fma, Gll, Aa^Fma, Aa^Fma, Aa^Fma, Hh, Hh, Hh, Aa, Aa, Gll^Fp, Gll^Fmw, Gll^Fdw, Gll^Fdw, Gll^Fmw, Re, Re, Gll^Fp, Gs, Gll^Fp, Gd, Gd, Ww, Gll, Gll, Gll, Gs, Gll^Fmw, Gs, Gll^Fmw, Gll^Fmw, Gll^Fmw, Gll^Fmw, Ww, Ww, Ss, Re, Gs, Gs^Fms, Ce, Ke, Ce
Aa^Fma, Ms, Hh, Hh, Gs, Aa, Aa, Hh, Ss, Hh, Hh, Ss, Ss, Gll^Fp, Gll^Fp, Gll^Fdw, Gll^Fdw, Gll^Fdw, Gd, Gll, Re, Aa, Aa, Gd, Gll^Fmw, Ww, Ww, Ww, Gll^Fmw, Ww, Ww, Gs, Gs, Gll^Fp, Gll^Fp, Gll^Fp, Aa, Ww, Cea, Cea, Ce, Re^Vct, Gs^Fms, Ce, Ce, Ce
Aa^Fpa, Aa^Fpa, Aa^Fpa, Hh^Vhh, Gs, Aa, Aa, Gll^Fmw, Ss, Ss, Ww, Ww, Ww, Gll^Fp, Gll^Fp, Gll^Fp, Ww, Gll^Fdw, Gll, Gd, Gll^Fmw, Re, Gll^Fmw, Gll^Fdw, Gll^Fmw, Gs, Ww, Gll^Fmw, Gll^Fmw, Gll, Gll, Gll^Fmw, Gs, Gll^Fmw, Gs^Fms, Gll^Fp, Gll^Fp, Aa, Ce, Ke, Ce, Gd, Gs^Fms, Gll^Fmw, Gll^Fp, Gs
Aa^Fma, Aa^Fpa, Aa^Fma, Ms, Gll^Fp, Aa, Gll^Fp, Gd^Fetd, Ww, Ww, Ww, Ww, Aa, Aa, Gll^Fp, Ww, Ww, Ss, Ww, Gll^Fdw, Hh, Re, Re, Gs, Ww, Ww, Gll^Fp, Gll, Gll^Fp, Gll^Fmw, Gll, Gll, Gll^Fp, Gll^Fp, Gll^Fp, Gs^Fms, Re, Re, Gll, Ce, Gll, Gll^Fmw, Gll^Fp, Gs^Fms, Gll^Fmw, Gs
Gll^Fp, Aa^Fma, Gll, Gll^Fp, Gll^Fp, Gll^Fp, Gll^Fp, Gll^Fp, Ww, Ww, Ww, Ww, Gll^Fp, Gll^Fp, Gll^Fmw, Ww, Gll^Fdw, Ww, Hh, Hh, Hh, Hh, Re, Ww, Ww, Ww, Rr^Vhc, Gll^Fp, Aa, Gll^Fp, Gll, Gll, Re, Re, Re, Re, Hh, Gs^Fms, Gll^Fdw, Gd, Gll^Fmw, Gll, Gll^Fp, Gs^Fms, Gll^Fmw, Gd
Gll^Fp, Gll, Gll^Fmw, Gll^Fdw, Aa, Gll^Fdw, Gll^Fp, Hh, Gll^Fp, Gll^Fp, Ww, Gll^Fdw, Gll^Fmw, Gll^Fp, Ss, Ss, Ss, Ss, Gll, Gll, Aa, Hh, Re, Re, Gs, Gs^Es, Rr, Gll^Fp, Re, Gll, Re, Re, Gll^Fp, Gll^Fp, Hh, Hh, Gll^Fp, Gll^Fdw, Gll^Fmw, Gs^Fms, Gll, Gll, Gd, Gll, Gs^Fms, Gd
Gd, Gll^Fmw, Gll^Fp, Aa, Gll, Gll^Fmw, Gll^Fdw, Hh, Gll^Fp, Ss, Gll, Ww, Ss, Ss, Ss, Gd, Gll, Gll, Gll, Aa, Re, Re, Rr, Gs, Gs, Gll^Fp, Re, Re, Gs, Re, Gll^Fp, Gs, Gd, Gd, Gll, Hh, Gll^Fmw, Gll^Fp, Gll, Gll, Gd, Gd, Gll^Fp, Gd, Gll^Fp, Gll^Fmw
Gll^Fp, Gll^Fp, Gll^Fmw, Gll^Fdw, Gll, Hh, Hh, Hh, Aa, Gll, Gll^Fp, Gll, Ww, Ww, Ww, Ww, Aa, Gll^Fp, Gll^Fp, Aa, Rr, Rr, Gll^Fp, Rr, Rr, Re, Gs, Gll^Fmw, Gs, Gll^Fp, Gll^Fp, Gd^Es, Gll^Fp, Gll, Gs, Gll, Ww, Gd, Gd, Gll, Gs^Vc, Gll^Fp, Gll^Fp, Gll^Fp, Hh, Hh
Aa, Gll^Fdw, Gll^Fdw, Gll, Gs^Vh, Hh, Gll, Gll^Fp, Aa, Gll^Fp, Gll^Fp, Gll, Ww, Ww, Ss, Re, Rr, Gll^Fp, Gs, Gll^Fp, Rr, Gll^Fp, Gll^Fp, Gll^Fp, Rr, Gs^Vh, Gs, Gs, Gll^Fp, Gll^Fp, Gll, Gll^Fp, Gll^Fp, Gll^Fmw, Gll, Gd^Es, Ww, Ww, Ww, Ss, Ss, Gd, Gs^Fms, Hh, Gll^Fp, Gll^Fp
Aa, Aa, Gll^Fp, Gd, Gd, Gll, Gd, Gll, Gd, Aa, Gll^Fp, Gll^Fp, Gll^Fp, Ww, Rr, Rr, Gs^Es, Rr, Rr, Rr, Gll^Fp, Hh, Gll, Gll^Fp, Gs, Rr, Hh, Hh, Gll^Fp, Gll^Fp, Gll^Fmw, Gll^Fmw, Gs^Fms, Gll^Fp, Gll, Ww, Ww, Ww, Ww, Ww, Ss, Ss, Gll^Fp, Hh, Gs^Fms, Gs
Gll^Fmw, Gll^Fmw, Gs, Gll^Fp, Gll^Fmw, Gd, Ss, Ss, Ww, Gs, Ch, Gs, Rr, Rr, Gs, Rr^Vhc, Gs, Gs, Gs, Hh, Gll, Hh, Gll, Gll, Gll^Fp, Rr, Gll^Fp, Hh, Gll^Fmw, Gll^Fmw, Gs^Fms, Gll, Gll^Fp, Gll^Fp, Gll, Gll, Gs^Fms, Gll, Ss, Ww, Ss, Gll^Fp, Gs, Gd, Gs, Gs
Gll^Fmw, Gs^Fms, Gll^Fmw, Aa, Gll^Fdw, Ww, Ww, Ss, Ww, Ch, Ch, Rr, Gs, Gs, Gs, Gs, Gs, Gd, Gd, Hh, Gll, Gll, Gs^Fms, Gll^Fmw, Gll, Rr, Gll^Fp, Hh, Gll, Gll^Fp, Gll, Gll^Fp, Gs^Fms, Gs^Fms, Gll^Fp, Gll^Fdw, Gll^Fdw, Gll, Gs^Fms, Ss, Gs^Fms, Gs, Gll, Gll, Gs, Gs
Gs^Fms, Gs^Fms, Gll^Fp, Aa, Aa, Gll^Fdw, Gs, Ss, Gs^Fms, Ch, Ch, Ch, Gll, Gs, Gll^Fmw, Gll^Fmw, Gll^Fp, Gll^Fdw, Gll^Fdw, Gd, Gll, Gd, Gs^Fms, Hh, Hh, Rr, Gll^Fdw, Gll^Fdw, Gll^Fp, Gll, Rr^Vhc, Gll, Gll, Gll^Fp, Gll, Gll^Fdw, Gll^Fdw, Gs^Fms, Hh, Gll^Fp, Gs^Fms, Gll, Gs, Gs, Gs^Es, Gs
Gs, Gs^Fms, Gll^Es, Aa, Gd, Aa, Gll^Fmw, Gs, Ww, Gll, Ww, Gs, Ss, Gll^Fp, Gll, Gll, Gll^Fdw, Gll^Fdw, Gd, Gll, Gs, Gll^Es, Gll^Fmw, Gll^Es, Re, Rr, Gll^Fp, Gll^Fdw, Gd, Gd, Rr, Gll, Gll^Fp, Gll^Fp, Ww, Gll, Gll, Gll^Fp, Gll^Fp, Hh, Gll^Fp, Gll, Gd, Gs^Vh, Gd, Gs
Hh, Gll^Fp, Hh, Gll, Gs^Fms, Gd, Gll^Fp, Gd, Gll^Fp, Ww, Ww, Ww, Ww, Ss, Gll, Gd, Gll^Fp, Gs^Fms, Gll^Fp, Gll, Gs^Fms, Gll^Es, Gll, Gll, Gs, Rr, Gs, Gd, Gs, Gs, Rr, Gll, Gll^Fp, Ww, Ww, Ww, Gs, Gll, Gll, Gll^Fp, Gd, Gd, Gd, Gs, Gs, Gs
Hh, Hh, Hh, Hh, Gll^Fmw, Gs^Fms, Gll^Fp, Gll^Fdw, Gll^Fmw, Gll^Fmw, Gll, Ww, Ww, Ss, Gs^Fms, Gll^Fdw, Gd, Gll, Gll^Fdw, Gll^Fp, Gd, Gll^Fmw, Gll, Gs, Gd, Rr, Rr, Re, Gs, Rr, Gll, Gll, Gll, Gll, Gll, Ww, Gs, Gll, Gs, Gs, Gll^Fdw, Gd, Gd, Gs, Gs, Gll^Fp
Gs, Ww, Ww, Gs^Fms, Gll^Fmw, Gd, Gll^Fp, Gll^Fp, Gs^Fms, Gs^Fms, Gll, Ww, Ww, Gd, Gll^Fdw, Gll^Fdw, Gll, Gll^Fp, Gll, Gll^Fdw, Ss, Ww, Ss, Ss, Gs, Gs, Gs, Rr, Rr, Rr, Rr, Gs, Rr, Gll, Gs, Ww, Ch, Ch, Ch, Gll^Fp, Gs, Gs^Fms, Gs^Fms, Gll^Fdw, Gll^Fdw, Gll^Fp
Gs, Ww, Ww, Gs, Gs^Fms, Gs^Fms, Gll^Fp, Gll^Fp, Gll, Gs^Fms, Gll, Ww, Gll, Gd, Gll, Gll^Fdw, Gs^Fms, Gll^Fp, Gll, Ss, Ww, Ww, Ww, Ss, Ss, Gs^Es, Gs, Rr, Gll, Gll, Gll, Rr, Gs, Rr, Rr, Gs, Rr, Kh, Ch, Gll, Gs, Gs, Hh, Hh, Hh, Hh
Gs^Fms, Ww, Gs, Ww, Ww, Gd, Gs, Gll, Gs^Vh, Gs, Ss, Ww, Ww, Gll, Gll^Fp, Gll^Fdw, Gs^Fms, Gll^Fp, Gll^Fp, Ss, Ww, Ww, Ww, Gs^Es, Ww, Gs, Rr^Vhc, Rr, Gd, Gs, Gs, Gs, Gll, Gs, Gs, Rr, Gs, Ch, Gll, Gs, Gd, Gll^Fp, Gll^Fp, Gll^Fp, Gs^Fms, Hh
Gs^Fms, Gs^Fms, Gll^Fp, Gs, Gll^Fp, Gll^Fp, Gll^Fp, Gll^Fp, Gll, Gll, Gll, Ss, Gll^Fp, Gs, Gs^Fms, Gd, Gs^Fms, Gs, Ss, Ss, Gs^Fms, Ww, Gll^Fp, Ww, Gll^Fp, Gs^Fms, Gd, Gs, Gll^Fdw, Gll^Fp, Gll^Fdw, Gs, Gs, Gll, Gll, Gs, Gs, Gll, Gs, Gll^Fp, Gll^Fp, Gd, Gll^Fp, Gs^Fms, Gs^Fms, Gs^Fms
Gs, Gs^Fms, Gll^Fp, Gd, Gs^Fms, Gs, Gll, Gs, Hh, Gll, Hh, Ss, Gll, Gll^Fp, Gll^Fp, Gs^Fms, Gll^Fp, Gll^Fp, Gll, Ss, Hh, Hh, Gll^Fp, Gll^Fp, Gs^Fms, Gs, Gd, Gll, Gll^Fp, Gll^Fdw, Gll, Gll^Fp, Gll^Fp, Gll^Fp, Gll^Fp, Gll^Fp, Gll^Fp, Gll, Gll^Fp, Gll^Fp, Gs^Fms, Gll^Fp, Gs^Fms, Gs^Fms, Gll^Fp, Gs
Gs, Gs^Fms, Gs, Gs^Fms, Gs, Gll, Gs, Gll, Gs, Hh, Hh, Hh, Gs, Gll, Gs, Gll^Fp, Gs, Gll, Gs, Gs, Gs, Hh, Hh, Gs^Fms, Gs, Gs^Fms, Gs, Gll, Gs, Gs, Gll, Gs^Fms, Gs^Fms, Gll^Fp, Gs, Gll^Fp, Gs, Gs^Fms, Gs, Gll^Fp, Gs, Gs^Fms, Gs^Fms, Gs^Fms, Gs, Gs^Fms
