Aa, Gll^Fp, Aa, Gll^Fmw, Gll^Fmw, Ce, Ce, Ce, Rp, Rp, Ss, Ss^Em, Ww, Aa, Aa, Gll^Fdw, Aa, Gll^Fmw, Ww, Ww, Ww, Ss, Ss, Ss, Cea, Cea, Cea, Cea, Cea, Ha, Ha, Mm, Mm, Aa^Fpa, Aa^Fpa, Ww, Cte, Gll^Fp, Cte, Cte, Cte, Cte, Cte, Cte, Mm, Ql, Mdd, Mdd, Mdd, Ql, Ql, Mdd, Ms^Xm, Ms^Xm, Ms^Xm, Mm, Ss^Vhs, Gs, Ss, Gs, Chs, Gs, Ss, Gll^Fp, Ww, Ss, Gll^Fp
Aa, Aa^Vca, Aa, Gll^Fmw, Ww, Gll^Fp, Re^Vct, Gll^Fp, Rp, Gs, Ss, Ww, Ww, Gll^Fmw, Gll^Fdw, Gll^Fdw, Gll^Fdw, Ww, Ww, Ww, Ww, Ww, Ce, Ce, Ce, Ket, Ce, Cea, Aa^Fpa, Ha, Mm, Aa, Mm, Chr, Cte, Cte, Ss, Cte, Mm, Cte, Kte, Cte, Rp, Cte, Cte, Chr, Cte, Mdd, Mv, Mdd, Mdd, Mdd, Ms^Xm, Ms^Xm, Gll^Fp, Gll^Fmw, Ss, Chs, Ww, Ss, Ss, Gll^Fp, Ss^Em, Ww, Ww, Ss, Ss
Gll^Fmw, Gll^Fmw, Gll^Fmw, Ww, Ww, Ss^Em, Ss, Rp, Gs, Re^Vct, Ce, Ce, Ce, Gs, Gll^Fmw, Gll^Fp, Gll^Fp, Ww, Ww, Ww, Ww, Gll^Fdw, Ce, Ce, Ce, Ce, Ce, Ce, Ww, Ww, Ss, Mm, Cte, Mm, Rp, Rp, Rp, Rp, Cte, Cte, Cte, Cte, Gll^Fp, Rp, Rp^Edb, Rr^Vd, Cte, Mm, Mm, Mm, Ms^Xm, Ms^Xm, Ms^Xm, Ms^Xm, Gll^Fmw, Ss, Mm, Ww, Ww, Ww, Ww, Gll^Fmw, Ss^Vhs, Chs, Ww, Ss, Gs
Gll^Fp, Gll^Fmw, Gll^Fp, Gll^Fmw, Ww, Ww, Cea, Rp, Re^Vct, Gs^Fms, Ce, Ke, Ce, Gs, Gll^Fp, Gll^Fdw, Gll^Fdw, Ww, Ww, Ww, Ss, Ce, Gll, Gll^Fp, Re, Gll^Fp, Gll, Ce, Ww, Ww, Mm, Gs^Fms, Rp, Rp, Rr^Vd, Mm, Aa, Cte, Hhd, Rp, Gll, Gll, Chs, Ql, Qlf, Rp, Rp, Md, Mdd, Cte, Aa, Aa, Ms^Xm, Ms^Xm, Gll^Fmw, Mm, Gll^Fmw, Chs, Gll^Fmw, Ww, Ss, Chs, Chs, Chs, Chs, Chs, Gs
Gll^Fmw, Gll^Fp, Gll^Fp, Aa, Aa, Cea, Ke, Ce, Gd, Gs^Fms, Gll^Fmw, Ce, Gs^Fms, Gs, Gll, Ss, Ss, Ww, Ww, Ww, Ss, Hhd, Re, Re, Aa, Re, Re, Ss^Em, Ww, Ww, Gll^Fp, Mm, Rb, Mm, Mm, Aa, Gll^Edb, Gll^Fdw, Gll, Rp, Khr, Chr, Chs, Chs, Khr, Qlf, Rp, Ql, Ql, Mdd, Aa, Chr, Mm, Ss, Ss^Em, Gll, Mm, Gs, Ss^Vhs, Ss^Em, Gs, Chs, Gll^Fdw, Gll^Fmw, Gll, Chs, Gll
Gll^Fp, Gs^Fms, Gs^Fms, Gll^Fp, Rp, Ce, Ce, Ce, Gll^Fmw, Gs^Fms, Gll, Gs^Fms, Gs, Re, Re, Aa, Gll, Ss^Em, Ss, Ss, Gll, Re, Aa, Gll, Gll, Gll, Gll, Re, Re, Gll^Fp, Re, Re, Gll^Edb, Aa, Mm, Aa, Gll, Gll, Mm, Rp, Chr, Gll^Fp, Ww, Ww, Chs, Gll, Rp^Edb, Mm, Qlf, Gs^Fms, Mm, Hhd, Mm, Ss, Mm^Edb, Mm, Ss, Ss^Em, Chs, Ss, Ss, Ss, Gll^Fmw, Ss, Gll, Ss^Em, Ss
Rp, Gll^Fp, Rp, Rp, Gs^Fms, Gll, Gd, Gll, Gll, Gll, Gll, Gll^Fmw, Gd^Es, Gll^Fdw, Gll, Re, Re, Gll, Gll^Es, Gll, Re, Re, Gll, Hh, Gll^Fmw, Aa, Gll^Edb, Hh, Gll, Re, Gll, Gll, Aa, Mm, Mm, Mm^Edb, Gll^Fp, Gll^Fp, Hhd^Edb, Rp, Rp, Ww, Gll, Ww, Gll, Gll, Rp, Rp, Cte, Rp^Edb, Rp, Hhd, Rp, Mm, Gll, Ss, Gll, Gll, Gll, Ss, Ss, Gll, Gll^Fp, Gll^Fmw, Gll, Gll, Ss
Gll^Fp, Rp, Hh, Hh, Gll^Fdw, Gll^Fdw, Gs^Fms, Re^Vct, Gll^Ecf, Gll, Gll, Gll, Gd, Gs, Gll, Gll, Re, Re, Re, Re, Gll, Gll^Fmw, Gll, Gll^Fp, Ww, Gll^Fp, Gll, Gll^Edb, Gll^Es, Mm, Gll^Fmw, Aa^Edb, Gll^Fmw, Mm, Chr, Gll^Fmw, Gll, Hh^Edb, Rp^Edb, Rp, Rp, Gll, Rp, Rp, Rp, Rp, Gll, Gs^Edb, Gs^Fms, Mm, Mm, Rp, Mm, Rp, Re, Gll^Fp, Gll, Aa, Gll, Gll, Chs, Gll, Ss, Gll^Fdw, Gll^Em, Chs, Gs
Gd, Hh, Hh, Gll^Fp, Gll^Fp, Gll^Fmw, Gll, Gll, Gd, Gd, Gd, Gll, Gll, Gs, Gll, Gll, Re, Gll, Gll, Re, Gll, Gll^Fp, Hh, Ww, Gll, Ww, Aa, Gll, Gll, Gll, Gll^Fmw, Gll, Mm^Edb, Mm, Rp, Gll, Rp^Edb, Rp, Gs^Fms, Hh, Hh, Rp, Mm, Gll, Gll, Gll, Gll^Fdw, Mm^Edb, Gs^Fms, Mm, Mm, Rr^Vd, Mm, Gll, Aa, Re, Re, Re, Re, Ss^Vhs, Ss, Ss, Chs, Ss^Vhs, Gll, Gll, Aa
Gll, Gll, Gll, Gll^Fmw, Gd, Gll, Gll, Gd, Gll^Fp, Gll^Fp, Gll^Fp, Gll^Fp, Hh, Gll, Aa, Re, Gll, Gll, Gll, Re, Re, Hh, Gs^Fms, Hh, Hh, Aa, Gll, Aa, Gll, Gll, Gll, Mm, Cte, Rp^Edb, Gll^Fdw, Rp, Mm, Rr^Edb, Mm, Hh, Gs^Edb, Rp, Gll^Fp, Mm^Edb, Rr^Vd, Gll, Chr, Mm, Mm, Mm, Mm, Gs, Gs^Edb, Aa, Gs^Fms, Gs^Edb, Gs^Fms, Gll, Gs^Fms, Re, Re, Gll, Gll, Ss, Ss, Gll, Gll
Gll^Fmw, Gs, Gd^Es, Ww, Ww, Gd, Ss^Em, Gs^Vc, Gd^Em, Gll^Fp, Hh, Hh, Gll^Fp, Gs, Gs, Re, Gll^Fdw, Gll, Aa, Gll^Fp, Re, Gll, Gs^Fms, Gs^Fms, Gs^Fms, Hh, Gll, Gll, Gll, Gll, Gll, Mm, Rp^Edb, Rp, Mm, Gll^Fp, Gll^Fdw, Mm, Gll^Fmw, Cte, Aa, Rp, Aa, Mm^Edb, Mm, Mm, Mm, Mm, Gll, Mm, Mm, Gs, Ww, Gll, Gs^Fms, Gs^Fms, Gs^Fms, Gs, Gll^Fp, Gll^Fp, Gll, Re, Gll, Ss, Gll, Gll, Gll
Gll^Fp, Gll, Ww, Ww, Ww, Ww, Ww, Ss, Ss, Gs^Fms, Hh, Gll^Fp, Gll, Gll, Gll, Re, Gll, Gll^Fp, Gll^Fdw, Gll^Fmw, Hh, Re, Re, Gs^Vh, Gll^Fp, Hh, Rp, Gll, Gll, Hh, Rp, Rp, Gll, Mm^Edb, Mm, Gll^Fp, Gll, Mm, Mm, Mm, Mm, Rp, Mm, Mm, Mm, Mm, Cte, Mm, Gs, Gll^Fdw, Gll, Gs, Ww, Gll, Gll, Gs^Fms, Gs^Fms, Hh, Gll^Fmf, Gll^Fmf, Gll, Re, Gll^Es, Gll, Hh, Gll, Gs
Gll^Fp, Gll, Gll, Ww, Gll, Ww, Ww, Ss, Gll^Fp, Gll^Fp, Gd, Gs^Fms, Gll, Gll, Gll^Fdw, Re, Re, Gll, Gll, Gll, Gll, Gll, Gll, Re, Rp, Rp, Gll, Rp, Rp, Rp, Gll, Gll, Hhd^Edb, Gll^Fdw, Gll, Gll, Hh, Gll^Fmw, Gll^Fp, Mm, Gs^Edb, Gll, Mm, Mm, Hh, Mm, Hh, Hh, Gll^Edb, Gll, Gll, Ww^Edb, Ww, Gll^Fp, Gll^Fp, Gs^Fms, Gs^Fms, Hh, Hh, Gll, Gll, Re, Gll^Fp, Gll, Gs^Fms, Hh, Hh
Gs^Fms, Gll, Gll^Fdw, Gs^Fms, Gll^Em, Ss^Em, Ss, Ss^Em, Gs, Gs, Gll, Gs, Gll, Gll, Gll, Gll, Re, Hh, Hh, Gs^Fms, Gs^Fms, Hh, Gs^Fms, Gll, Rp, Gll^Fdw, Gll, Gll, Gll^Fp, Gll^Fp, Gll^Fmw, Gll^Fmw, Hh, Hhd^Edb, Gll^Fmw, Gll, Gll, Gll, Gll^Edb, Gs^Fms, Gll^Fmw, Gll, Gll, Gll, Gs, Hh, Hh, Gs^Fms, Gll^Edb, Gll, Gll, Gll, Gll, Gll, Gll, Gll, Re, Gll, Re, Re, Re, Re, Gll, Gll^Fmf, Gs^Fms, Gll, Gs
Gll^Fp, Gll^Fp, Gll^Fdw, Gll^Fdw, Gs^Fms, Gs^Fms, Gll^Fp, Gs^Fms, Gll, Gll, Gs, Gll, Gll, Gll, Re, Re, Gll, Hh, Gs^Fms, Gs^Fms, Gs^Fms, Gs^Fms, Rp, Rp, Gll, Gll, Gll, Gll^Fp, Ww, Ww, Ww, Gll^Fmw, Ww, Hh, Gll^Fmw, Gll^Fmw, Gll^Fmw, Gll, Gll^Fdw, Gll, Gll, Gll, Gll^Fmw, Gll, Gs^Fms, Gs^Fms, Gs^Fms, Gs^Fms, Gs, Gll, Gs, Re, Re, Gll, Re, Re, Gll^Fmf, Re, Gll^Fp, Gll^Fp, Gll, Re, Re, Hh, Hh, Gll, Gll^Fp
Gll^Fp, Gll, Gll, Gll^Fdw, Gll^Fp, Hh, Hh, Gs^Fms, Gll, Gs, Gs^Vh, Gs^Es, Gll^Fdw, Re, Gll^Fmw, Gll^Fdw, Gll^Fmw, Gll, Gll, Hh, Gll, Gll, Rp, Gll, Gll^Fdw, Gll, Ww, Gll^Fp, Ww^Ewl, Ww, Ww^Ewl, Ww, Ww, Hh, Hh, Hh, Gll^Fmw, Gll, Gll^Edb, Gll, Gll, Gll, Gll^Fp, Gs, Gll^Edt, Gs, Gll, Gll, Gll, Gs^Fms, Gll, Gs, Gll^Fmw, Re, Gll^Fmf, Gll^Fmf, Gll^Fmw, Gll^Fmw, Gs^Em, Gll^Fmf, Re, Re, Gll^Fmw, Re, Re, Gll, Gll^Fp
Ww, Ww, Ww^Ewl, Gll, Gll, Gll^Fp, Gll^Fp, Gll^Fp, Gd, Gd, Re, Gll^Fp, Re, Re, Re, Gll^Fmw, Gll^Fdw, Gll, Gll, Gll, Rp, Rp, Gll, Gll, Gll^Fp, Gll, Ww, Ww^Ewf, Ww^Ewl, Ww^Ewf, Ww^Ewl, Ww, Ww, Hh, Gll^Fmw, Hh^Edb, Gll^Edb, Gll, Gll, Gll^Fmf, Gll, Gll, Gll^Edb, Gll^Edt, Gll, Gll^Fmf, Gll^Fp, Gll^Fmw, Gll, Gll, Gll^Fmf, Gll^Fmw, Gll^Fp, Gll^Fmf, Gll, Gll^Em, Gll^Fmw, Gll^Fmw, Gll^Fp, Gs^Fms, Re, Gll^Fp, Gll^Es, Gll^Fmw, Gll, Re, Gll
Gll, Ww, Ww, Gs, Gll, Gll, Gs, Gd, Gd, Gd, Gs, Re, Gll^Fp, Hh, Re, Gll, Gll^Fp, Gll^Es, Rp, Rp, Gll, Gll, Gs^Fms, Gs^Fms, Gll^Fp, Ww, Ww^Bw/, Hh^Vhh, Ww^Ewl, Ww^Ewl, Ww, Ww, Hh, Hh, Gll^Fmw, Gll^Edb, Gll, Gll, Gll^Edt, Gll^Es, Gll, Gll^Edb, Gll^Edt, Gll, Gll, Gd^Vhr, Gll^Edb, Gll^Fmw, Gll, Gll^Fmf, Gll, Gll^Fmw, Gll^Fmw, Gll^Fmf, Gll, Gll^Fmf, Gd^Vhr, Gll^Fmf, Gll^Fmf, Gll, Re, Gll, Gll^Em, Ss, Ww, Gll, Gs
Gll, Gll, Ww, Gs, Ch, Gs, Gll^Fp, Gll^Fdw, Gs^Fms, Gd, Gll^Fdw, Gs, Gll^Fp, Hh, Re, Gll, Gll^Em, Rp, Gll^Fmf, Gll^Fp, Gll^Fmf, Gll^Em, Hh, Gs^Fms, Gs, Re, Re, Ww, Gll^Fp, Ww^Ewf, Ww, Ss, Ss, Gll^Fmw, Gll^Fmw, Gll^Es, Gll^Es, Gll, Gll^Edt, Gll^Edt, Gll^Edb, Gll^Edt, Gll^Edt, Gll^Edb, Gll, Gll, Gll^Fmw, Gll^Fmf, Gll, Gll, Gll, Ww, Ss, Gll, Gll, Gll^Edt, Gll, Hh, Re, Re, Gll^Fmf, Ss, Ss, Ss, Ww, Ww, Ww
Rr, Gs, Gs, Ch, Kh, Ch, Gll, Gs, Gs, Gs^Fms, Hh, Gll^Fdw, Hh, Hh, Gll, Re, Re, Rp, Gll^Fmf, Gll^Fmw, Gll^Fmf, Hh, Hh, Gll, Gll^Fp, Gs, Gll^Fmf, Re, Re, Gll^Fp, Gll, Ss, Re, Gll, Gll^Fdw, Gll^Fdw, Gll, Hh, Hh, Gll, Hh, Gll, Gll, Gll^Edb, Gll^Edb, Gll^Edt, Gll^Fmf, Hh, Hh, Gs^Em, Ss^Em, Ww, Ww, Ss^Em, Gll, Gll, Re, Re, Hh, Re, Re, Ss, Ss, Ww, Ww, Ww, Ww
Gs, Rr, Rr, Rr, Ch, Ch, Gs, Gs, Gll^Fp, Hh, Hh^Vhh, Hh, Hh, Gll, Gll^Fmw, Gll^Fp, Gll, Rp, Gll^Fmf, Gll^Fmf, Gll^Em, Gll, Hh, Gll, Gll^Fmf, Gll^Fp, Re, Re, Gll, Re, Re, Re, Gll^Fmf, Re, Re, Gll, Gll^Fdw, Hh, Gll, Hh, Gll, Hh, Hh, Gs, Gs, Gll, Gll^Fmf, Gll, Gll^Fmf, Gll, Gll, Ww, Hh, Ss^Em, Hh, Gll, Re, Gll, Ss, Hh, Hh, Re, Gll^Fdw, Ss^Em, Ss, Ww, Ww
Gll, Gs^Es, Gs, Gs, Rp, Gll, Gll^Fp, Gd, Gd, Gll^Fp, Gs^Fms, Gs^Fms, Gs^Fms, Hh, Gll^Fmw, Gll^Fmw, Gll^Fp, Rp, Gll, Gll^Fp, Gs, Hh, Hh, Gll^Fmf, Hh, Gll^Fmf, Re, Hh, Gll, Gll^Fmf, Gll^Fmf, Gll^Fmw, Gll^Fp, Gll, Gll^Fmf, Re, Gll, Gll^Fmf, Gs, Gll, Gll, Gs^Es, Gs, Gs, Gs, Gll, Gll^Fmf, Gll^Fmf, Gll^Fp, Gll^Fmf, Re, Gll^Fmf, Re, Gll, Re, Gs, Gll^Fdw, Ss, Ss, Gll^Fdw, Gll^Fdw, Re, Ss, Gll^Fdw, Re, Ww, Gll
Gll^Fp, Gll, Gll^Fp, Gs, Gll, Rp, Gll^Fmw, Gll^Fp, Gll^Fp, Gll^Fp, Gs^Fms, Gs^Fms, Hh, Gll^Fmw, Gll^Fmw, Gll, Ch, Rp, Re, Re, Re, Re, Re, Gll, Gll, Hh, Gll^Fp, Re, Gs, Gs^Vh, Gll^Fmf, Gll, Gll^Em, Gll^Fmf, Gll, Re, Gll^Fdw, Gll, Gll^Fmf, Gs^Vh, Gll^Fmf, Gll, Gs, Gll, Gs, Gll^Fmf, Gll^Em, Gll, Gll^Fmf, Gll^Fmf, Re, Re, Gll, Re, Gll, Re, Gll^Fdw, Gs, Gll, Ss, Gll, Gll^Fp, Ker, Cer, Gll, Re^Edt, Gll
Gll^Fp, Gll^Fp, Gll^Fp, Gs^Fms, Gs^Fms, Rp, Gll^Fp, Gs^Fms, Gs^Fms, Gs^Fms, Gs^Fms, Gll^Fp, Hh, Hh, Gll, Gll, Rr, Rp, Ch, Ww, Gs^Fms, Gll^Fp, Gll, Re, Re, Re, Re, Re, Mm, Gll^Fmf, Gll^Fmf, Ss, Gll^Fmf, Gll^Fmf, Gll^Em, Re, Hh, Gll, Gll, Gll^Fmf, Gll^Fp, Gll^Fmf, Gll^Fmf, Gll, Hh, Gs, Re, Re, Re, Re, Gll, Gll^Edt, Gll^Fdw, Gll^Fdw, Gll, Gll^Fdw, Gll^Fdw, Gs^Edt, Gll, Gll^Fdw, Cer, Cer, Gll^Fdw, Gll^Fdw, Ss, Gd^Vhr, Gs
Gs^Fms, Gs^Fms, Gs, Gll, Rp, Rp, Gll^Fmw, Gll, Ww, Ww, Gll^Fmw, Gll^Fmw, Gll^Fmw, Gll^Fmw, Rr^Es, Rr, Gll^Fmw, Gll^Fmw, Ss, Ss, Gs^Fms, Hh, Gll, Re, Gll, Mm, Hh, Mm, Mm, Mm, Hh, Ss^Em, Mm, Gll^Fmf, Re, Re, Gll, Hh, Re, Gll^Fmf, Re, Re, Re, Re, Re, Re, Gll, Gll^Fdw, Gll, Gll^Edt, Gll, Gll, Gll^Fp, Gll, Cer, Gs, Gll^Fdw, Gll^Fdw, Gll, Gll, Gll, Gll^Em, Gs^Fms, Gll, Gll^Edt, Ss^Edt, Gll
Gll, Gll, Gll, Gll, Rp, Gll^Fp, Gll^Fp, Gll, Ww, Ww, Ww, Gll, Rr, Rr, Hh, Hh, Gll^Fmw, Gll^Fmw, Gll^Fp, Ss, Gll, Ww, Gll^Em, Re, Gll^Fmf, Gll^Fmf, Hh, Hh, Mm, Mm, Mm, Mm, Gll, Re, Hh, Re, Re, Re, Gll, Re, Gll, Gll^Fmf, Gll, Gll, Gs^Fms, Gll, Gll^Fdw, Gll, Gs, Gs, Gll^Fdw, Gll^Fp, Gll, Gll^Fdw, Ker, Gll, Gll^Fdw, Gll^Fdw, Gll^Edb, Gll, Cer, Gll^Edb, Gs^Fms, Gll, Hh, Ss, Gs
Gs, Gs, Gll^Fp, Gll^Fmw, Rp, Rp, Rp, Ss, Rr, Rr, Rr, Rr, Gll, Gll, Hh, Hh, Gll^Fmw, Hh, Ss, Ss, Ss, Gll, Gll^Fp, Re, Gll, Mm, Gll^Em, Hh, Mm, Mm, Mm, Hh, Mm, Re, Hh, Gll^Fp, Gs^Fms, Gll, Gll, Gll^Fmw, Gll^Fp, Gll, Gll, Gs, Gd^Vhr, Gs^Fms, Gll, Gll^Fdw, Gll, Gll^Fdw, Gs^Edt, Gll, Gll, Cer, Gll^Es, Gll, Gll, Gll^Fdw, Gll^Fdw, Gll^Fdw, Gs^Fms, Cer, Gll, Gll, Gs^Edt, Gs^Edb, Gll^Fdw
Gll, Gll, Gll^Fp, Gll, Rr, Hh, Rr, Rr, Ch, Gll^Fp, Gll^Fp, Gll, Gs, Hh, Gll, Gll^Fmw, Gll^Fmw, Gll, Gll, Gll, Gll, Gs, Re, Re, Hh, Gs, Mm, Mm, Mm, Hh, Hh, Gll^Fp, Gs^Fms, Re, Gll^Em, Hh, Gll^Fp, Gll, Gll^Fp, Gll, Gs, Gll, Gs, Hh, Gs^Fms, Gll, Ww, Gll, Gll^Fdw, Gll^Fdw, Gs^Fms, Gll, Gll^Fmw, Gs, Cer^Edb, Gll, Gll^Fdw, Gll^Edt, Gs^Edb, Gll, Hh, Gll, Cer^Edb, Gll, Gll^Fdw, Gll^Fdw, Gll^Fdw
Hh, Rr^Vhc, Rr, Rr, Gs^Fms, Rr, Ch, Ch, Ch, Gll^Fp, Gll, Gll^Fp, Gll, Hh, Gll, Gll, Gs^Fms, Gs, Gll, Gll, Gll, Hh, Gll, Gll^Fp, Re, Re, Re, Re, Gll^Fp, Gll^Fp, Re, Mm, Re, Re, Ss, Gll^Fp, Ww, Gll, Gll^Fp, Gs^Fms, Gll^Fp, Gll, Gll^Fdw, Hh, Gs, Ww, Ww, Gll, Gll^Fp, Gll^Edb, Gs^Fms, Gll^Fdw, Gll^Fp, Gll, Gll, Cer^Edb, Gll, Gs^Fms, Gll^Edb, Gs, Gs, Hh, Hh, Gll, Gll^Fdw, Gll^Fdw, Gll^Fdw
Rr, Rr, Gs, Gll, Gs, Rr^Vhc, Gll^Fmw, Kh, Gll, Gll, Gll, Gll, Gll, Gll, Gll, Gll, Gll^Fp, Gll, Gs^Fms, Hh, Gs, Gs, Gs^Fms, Gll^Fp, Re, Gll, Hh, Hh, Re, Re, Gll, Re, Gd^Vhr, Gs, Ss, Ww, Ww, Gs^Fms, Gll, Gs^Fms, Gll, Gs^Fms, Hh, Gll^Fdw, Gs, Gll, Ww, Ww, Cer, Gll^Edb, Gll, Gll^Fdw, Gll^Fdw, Gd^Vhr, Gll, Gll^Edt, Cer, Ker, Cer, Hh, Hh, Gll, Cer, Gll, Gll^Fdw, Gll^Fdw, Gs
Gs, Gs, Hh, Gs^Es, Gll, Gll^Fmw, Gll^Fp, Gs^Fms, Gll, Gll, Gll, Gll, Gll^Fp, Gll, Gll, Gll, Gll, Gll^Fp, Gs^Fms, Gll, Gll, Gs^Fms, Gll, Gll, Re, Re, Re, Re, Gs^Fms, Gs^Fms, Gll, Gll, Gll^Fp, Gs, Ss^Em, Ww, Ss, Gs^Fms, Gll, Gs^Fms, Gll, Hh, Gll, Hh, Gs, Gll^Fdw, Ww, Ww, Ker, Gs^Fms, Gll^Fp, Gll^Edb, Gll^Fdw, Gll^Fdw, Gll^Fdw, Gll^Edt, Gll, Gll^Fmw, Gll^Fdw, Gll, Hh, Cer, Cer, Cer, Cer, Gll, Gll
Hh, Gll, Gs^Fms, Gll^Fp, Gll, Gll, Gll, Gll^Fp, Gll, Gs^Fms, Gs^Fms, Gs^Fms, Gll^Fp, Gs, Gll^Fmw, Gll, Gll, Gll, Gll, Gll, Gll^Fmw, Gll, Gll^Fp, Gll^Fp, Gll, Gll^Fmw, Gll^Fp, Re, Gll, Gll, Gs, Gll^Fp, Gll, Gll, Hh^Vhh, Ss, Gs^Fms, Gs^Fms, Gll, Gs, Gll, Gs, Gs, Gll^Fdw, Gs^Fms, Gll, Gll^Fdw, Gs^Fms, Gll, Cer, Gll^Fp, Gs, Gll, Gll^Edb, Gll^Fdw, Gs^Edt, Gll, Gll^Fdw, Gs, Gs, Gs, Cer, Cer, Ker, Cer, Gll^Fp, Gll
Gs, Hh, Gs, Gs, Gll, Gll, Ww, Gll, Gll, Gll, Gs, Gs, Gll, Gs, Gs, Gs, Gll^Fp, Gll^Fmw, Gll^Fmw, Gll, Gll, Gll^Fp, Gll^Fmw, Gll, Hh, Gs, Gll, Gll, Gll^Fp, Gs, Gs^Fms, Gs^Fms, Gll, Gll, Gs^Fms, Hh, Gs^Fms, Gs, Cvr, Gll^Es, Gs^Fms, Gs^Fms, Gll^Fdw, Gll^Fdw, Gll^Fdw, Gll^Fdw, Gs, Gs, Gs, Gll^Fmw, Gll, Cer, Ker, Gll, Gs^Edb, Gs^Edb, Gs^Fms, Gs, Gll, Gll, Gs, Gs, Cer, Cer, Cer, Gll, Gs
Gs, Gs^Fms, Gs^Fms, Gs, Ww, Gll^Fp, Ww, Gll^Fp, Gll, Gs^Fms, Gs, Gll, Gs^Fms, Gll, Ss, Gll, Gll, Gll, Hh, Gll^Fp, Gs, Gll^Fp, Gll, Gs, Gll, Hh, Gll^Fp, Gll, Gll, Gll^Fp, Hh, Gll, Gs^Fms, Gs^Fms, Gs^Fms, Gs^Fms, Gs^Fms, Gs^Fms, Gs^Fms, Gll, Gs^Fms, Gs^Fms, Gs^Fms, Gll, Gs^Fms, Gll^Fdw, Gll^Fdw, Gll^Fdw, Gd^Vhr, Gs, Gs, Gll, Gll, Cer, Gll, Cer, Cer, Gll, Cer, Cer, Gs^Fms, Gs, Gs^Edt, Cer, Gs, Gs, Gll
Gs, Gs, Gs, Gll, Ww, Ww, Ww, Gll, Gs, Hh, Gs, Gs, Hh, Hh, Ww, Gll, Ww, Ss, Gs, Gll, Gs, Gs, Hh, Gs, Gs, Gll, Gll, Gll, Gs, Gll, Gs^Fms, Hh, Gs^Fms, Gs, Gs^Fms, Gs^Fms, Gll, Gs, Gll^Xo, Gs^Fms, Gs, Gs^Fms, Gs^Fms, Gs^Fms, Gs^Fms, Gs^Fms, Gll^Fdw, Gs^Fms, Gs^Fms, Gll^Edt, Gs^Fms, Gs, Gll, Gs^Edb, Gll^Edt, Gs^Edt, Gll, Ker, Gll, Gll, Gs, Gs, Gs, Gll^Fp, Gll, Gll, Gll
Gll, Hh, Hh^Vhh, Gs, Ww, Gs^Fms, Gs, Gll, Gs^Fms, Gs, Gll, Gll, Gll^Fp, Gll^Fp, Ww, Ww, Ww, Ss, Gs, Gs, Gs, Gll, Hh, Gs^Fms, Gs, Gs, Gs, Gs, Gs, Gs^Fms, Gs, Gs^Fms, Gs, Gs^Fms, Gs^Fms, Gs, Gs^Xo, Gs^Xo, Gg^Fet, Gs^Xo, Gs^Xo, Gs^Fms, Gs^Fds, Gs^Fms, Gs^Fms, Gs^Fms, Gs^Fms, Gs^Fms, Gs^Fms, Gll^Fdw, Gs, Gs^Fms, Gll, Gll, Gs^Edb, Gs, Gd^Vhr, Gll, Gll, Gll^Fp, Gll, Gll^Fp, Gll, Gll^Fp, Gs, Gs, Gs
Gll, Hh, Hh, Gll^Fp, Ww, Ww, Gll^Fp, Gll, Gll^Fmw, Gll, Gll, Gll^Fmw, Ss, Gll^Fp, Ww, Ww, Ss, Gs, Gs, Gll, Gll, Gs, Gs, Gs^Fms, Gll, Gs^Fds, Gs^Fms, Gs^Fms, Gs, Gs^Fms, Gs, Ww, Ww, Gs, Gs^Xo, Gs^Xo, Gs^Fds, Gs^Xo, Gll^Fdf, Gs^Fds, Gs^Xo, Gs^Fms, Gs^Xo, Gs, Gs^Es, Gs^Fms, Gs^Fms, Gs^Fms, Gs^Fms, Gs^Fms, Ker, Gs, Gll, Gll, Gs, Gll, Gll, Gll, Gs, Gll, Gs, Gs, Cer, Gll, Gs^Fds, Gd^Vhr, Gll
Gll, Gll^Fp, Hh, Gll^Fp, Gll, Gll, Gll^Fp, Gll, Gll^Fp, Gll^Fp, Gll, Gll, Gll, Ss, Ss, Ww, Gll^Fp, Gll^Fp, Gs, Gll, Gs, Gs, Gs, Gs, Gs^Fds, Hh, Gs^Es, Gs^Fms, Gs^Fms, Gs^Fms, Gs^Fms, Gs^Fms, Ww, Ww, Gs^Xo, Gs^Fds, Gll^Fdf, Gs^Ii, Gs^Fds, Gll^Fdf, Gll^Fdf, Gs^Xo, Gs^Fds, Gs^Xo, Ww, Gs, Ww, Gs, Ww, Gs^Fms, Gs^Fms, Cer^Edb, Gs^Fms, Gs, Gs, Gs, Cer, Gs^Fms, Gs, Cer, Gs^Fds, Ker, Gll, Gll, Gll, Gll, Gll
Gs, Gll, Gll^Fp, Gll, Gll, Gll^Fp, Gll^Fp, Gll^Fp, Ss, Ss, Gll^Fp, Gll, Gs^Fms, Ss, Gll, Gll, Gs^Fms, Gs^Fms, Gs, Hh, Gs, Gs, Gs^Fms, Gs, Gs, Gs^Fds, Gs^Fms, Gs^Fds, Gs^Fms, Gs^Fms, Ww, Ww, Ww^Xo, Gs^Xo, Gll^Fdf, Gll^Fdf, Gs^Fds, Gg, Gg^Ve, Gs^Fds, Gs^Fds, Gs^Ii, Gs^Ii, Gs^Xo, Ww^Xo, Ww, Ww^Xo, Gs, Ww, Gs^Fms, Gs^Fms, Gs^Fms, Gs^Fms, Gs^Fms, Gs^Fms, Gs^Fms, Gs^Fms, Gs^Fds, Gll^Fdw, Gll^Fdw, Gll, Gll, Gs^Edb, Hh, Cer, Gll, Gll
Gs, Gll, Gs, Gs, Gs, Gll, Gll^Fp, Ss, Ss, Ss, Gll, Gll, Gs^Fms, Gll, Gll, Gll, Hh, Gs, Gs, Gs, Gll, Gll, Gs^Fms, Gs^Fms, Gs^Fms, Gs, Cvr, Gll, Gs^Fms, Gs, Gs^Xo, Ww^Xo, Gs^Ii, Gs^Ii, Gg, Gs^Fds, Gg^Efm, Gs^Fds, Cv, Gs^Fms, Gs^Fds, Gg, Gg^Efm, Gll^Fdf, Gs^Ii, Ww^Xo, Gs^Fms, Ww^Xo, Gs^Xo, Gs, Gs^Fms, Cvr, Gs^Fms, Gs, Gs^Fms, Gs^Fms, Gs^Fms, Gs, Gll^Fdw, Gll, Ww, Gll, Gll, Gs^Fms, Ker, Gll, Gll
Gs, Gll, Gs, Gs, Gs, Gs^Fds, Gs, Gll^Fp, Gs, Ss, Gll, Hh, Gll, Gs, Gs^Fds, Gs, Gs, Gll, Gs, Gs, Gs^Fms, Gs^Fms, Gs^Fms, Gs^Fms, Gs^Fds, Gs^Fms, Gs^Fds, Gs^Fms, Gs^Xo, Gs^Xo, Gs^Ii, Gs^Ii, Gg^Ve, Gs^Fds, Cv^Efm, Gg, Gg^Efm, Gg, Kv, Gs^Fms, Gs^Fms, Gs^Fds, Cv, Gs, Gs^Fds, Gs^Ii, Gs^Ii, Gs^Efm, Gg^Fet, Gs^Xo, Gs^Fms, Gs^Fms, Gs^Fms, Gs^Fms, Gs^Edt, Gs^Fds, Gll^Fdw, Gll^Fdw, Gll^Fdw, Ww, Ww, Ww, Ww, Gll, Cer, Gll, Gs
Gs, Gs, Gs^Fds, Gs, Gs^Fds, Gs, Gll, Gs, Gll^Fp, Gs, Gll^Fp, Gll, Gs, Gs, Gs, Gs, Gs^Fds, Gll^Efm, Gll, Gs, Gs^Fms, Gs^Fds, Gs, Gs^Fds, Gll, Gs, Gs, Gs^Fds, Gs^Xo, Gg^Fet, Gg, Gg, Gs^Fms, Gs^Fds, Gs^Fms, Cv, Cv, Cv, Gs^Fds, Cv, Cv, Cv, Gg^Efm, Gs, Gs^Fms, Gg, Gs^Fds, Gll^Fdf, Gs^Fds, Gs^Xo, Gs^Fms, Gs^Fds, Gs^Fms, Gs^Fms, Gs^Fms, Gs^Fms, Gs^Fms, Gll^Fdw, Gs^Fms, Gll, Gll, Ww, Gs^Fms, Gs^Fms, Gs, Gll^Fdw, Gs
Gs, Gs, Gs, Gs, Gs^Fds, Gs, Gs, Gs, Gs, Gll^Fp, Gs^Fms, Gll, Gs, Gs, Gs, Gs, Gll^Fp, Gs^Fds, Gs, Gs, Gs, Gs^Fms, Gs^Fds, Gs^Fms, Gs^Fms, Gs^Fms, Gs^Fms, Gs^Xo, Gs^Fds, Gs^Ii, Gs^Fms, Gs^Efm, Gg, Gs^Fds, Gg^Ve, Gg, Kv, Gg^Efm, Gg^Efm, Gs^Fds, Kv, Gs^Fms, Gg^Efm, Gs, Gs^Fds, Gs^Fds, Gs^Efm, Gll^Fdf, Gs^Xo, Gs^Xo, Gs^Fms, Gs^Fms, Gs^Es, Gs^Fms, Gs^Fms, Gs^Fms, Gll^Fdw, Gs^Fms, Gs^Fms, Gs^Fms, Gs^Fms, Gs^Fms, Gs^Fms, Gs^Fms, Gs, Gs, Gs
Gs^Fds, Gs^Fms, Gs^Fds, Gs^Fms, Gs^Fms, Gll^Fp, Gs^Fds, Gs^Fds, Gs, Gs^Fms, Gs^Fms, Gs, Gs, Gs, Gs^Fds, Gll^Fp, Gs, Gll, Gs^Fms, Gs^Fms, Gs^Es, Gs^Fds, Gs^Fds, Gs, Gs, Gs^Es, Gs^Fds, Gs^Xo, Gs^Xo, Gs^Ii, Gs^Efm, Gs^Fds, Gs^Fds, Gs^Fds, Gs^Fds, Gs^Efm, Cv^Efm, Gg^Efm, Gg^Efm, Gg^Efm, Cv^Efm, Gs^Es, Gg^Ve, Gs^Fds, Gg^Efm, Gg, Rb^Gvs, Gs^Ii, Gs^Xo, Gs^Fds, Gs^Fms, Gs, Gs, Gs^Efm, Gs^Fms, Gg^Ve, Gs^Fms, Gll^Fdw, Gs^Fms, Gs^Fms, Gs, Gs^Fms, Gs, Gll^Fdw, Gs^Fds, Gs^Fds, Gll^Fdw
Gs^Fds, Gs^Fms, Gg^Ve, Gs^Fds, Hh^Es, Gs^Efm, Gs, Gs^Fds, Gs^Fds, Gs, Gs, Gs, Gs^Fms, Gs^Fds, Gll, Gs, Gs^Efm, Gs^Efm, Gs^Efm, Gs^Efm, Gs^Fms, Gs^Fms, Gs^Fms, Gs, Gs, Gs^Fds, Gs, Gs^Fds, Gs^Xo, Gll^Fdf, Gs^Fms, Gs^Fds, Ww, Gs^Fds, Cv, Cv^Efm, Gs^Fms, Cv, Kv, Cv, Gs^Fms, Cv^Efm, Cv, Gg, Rb^Gvs, Rb^Gvs, Rb^Gvs, Gs^Ii, Gs^Fms, Gs^Xo, Gs^Es, Gs, Gs^Fds, Gs, Gs^Fms, Gs^Efm, Gs^Fms, Gs^Fms, Gll^Fdw, Gs^Fms, Gs^Es, Gll^Fdw, Gs^Fms, Gs^Fds, Gs^Fms, Hh, Gs
Gs^Fds, Gs^Fds, Gs^Fds, Gs^Fms, Gs, Gs^Efm, Gs^Efm, Gs^Efm, Gs, Gs^Fms, Gs^Fds, Gs^Fds, Gs, Gs^Fds, Gs, Gs^Efm, Gs^Efm, Gs^Efm, Gs^Fds, Gs^Efm, Gs^Fms, Gs^Es, Gs, Gs^Es, Gs^Fds, Gs^Fms, Gs, Gs^Xo, Gg^Fet, Gll^Fdf, Gs^Efm, Ww, Gg^Ve, Ww, Ww, Gs^Fds, Ww^Ewf, Gg^Efm, Cv, Gs^Fms, Ww, Gs^Fms, Rb^Gvs, Rb^Gvs, Rb^Gvs, Rb^Gvs, Rb^Gvs, Gs^Ii, Gg^Fet, Gs^Xo, Gs, Gs^Fms, Gs, Gs, Gs^Fms, Gs^Fms, Gs, Gs^Fds, Gs^Fms, Gll^Fdw, Gs, Gll^Fdw, Gs^Fds, Gs, Gs^Efm, Gs^Efm, Gs
Gs, Gs^Fds, Gs^Fds, Gs^Fds, Gs^Fms, Gs^Efm, Gs^Efm, Gs^Efm, Gs, Gs, Gs, Gs, Gs^Fms, Gs^Fms, Gs^Efm, Gs^Efm, Gs^Fds, Gs^Fds, Gs^Fms, Gs, Gs, Gs^Fds, Gs^Fms, Gs^Fms, Gs, Gs, Gs^Fds, Gs^Xo, Gs^Xo, Gs^Ii, Gs^Fms, Gs^Fds, Gs^Efm, Gs^Fds, Gg^Efm, Ww, Ww, Gg^Efm, Cv, Gg^Ve, Ww, Ww^Ewf, Ww, Rb^Gvs, Rb^Gvs, Rb^Gvs, Rb^Gvs, Gll^Fdf, Gs^Xo, Gs^Xo, Gs^Fds, Gs^Fds, Gs, Gs^Es, Gs, Gs^Fms, Gs^Fms, Gs, Gs^Fms, Gs, Gs^Efm, Gs, Gs^Fms, Gs, Gs, Gs^Efm, Gs^Efm
Gs^Fds, Gs^Fds, Gs, Gs^Fms, Gs^Fds, Gs, Gs^Fds, Gs, Gs, Gs^Efm, Gs^Fds, Gs^Efm, Gs, Gs^Fds, Gs^Fds, Gs^Fds, Gs^Fms, Gg^Ve, Gs^Fds, Gs^Fms, Gs, Gs^Fds, Gs, Gs^Fds, Gs, Cvr, Gs^Fds, Gs^Fds, Gs^Xo, Gll^Fdf, Gll^Fdf, Gs^Fms, Gg, Gg^Efm, Gs^Fms, Gg^Ve, Ww^Ewf, Ww, Ww^Ewl, Ww^Bw\, Gg^Efm, Gs^Fds, Ww^Bw/, Gg^Ve, Ww, Rb^Gvs, Gs^Ii, Gs^Ii, Gs^Xo, Gs^Fds, Gs, Gs^Fds, Gs^Fms, Gs^Fms, Gs^Fds, Gs^Fds, Gs^Fms, Gs^Fms, Gs^Fms, Gs^Efm, Gs, Gs, Gs, Gs^Fds, Gs^Fds, Gs^Efm, Gs
Gs, Gs, Gs^Efm, Gs, Gs, Gs^Fms, Gs^Fds, Gs^Fds, Gs^Es, Gs, Gs, Gs^Fds, Gs, Gs, Gs, Gs^Fds, Gs^Fms, Gs^Fds, Gs^Fms, Gs^Fds, Gs^Fms, Gs^Fms, Gs, Gs^Es, Gs^Efm, Gs^Fms, Gs, Gs, Gs, Gs^Xo, Gs^Xo, Gll^Fdf, Gs^Ii, Gs^Fds, Ww, Gs^Fms, Ww, Gs^Fms, Gg^Ve, Ww^Ewf, Ww, Gg^Efm, Ww^Ewl, Ww^Ewl, Gs^Ii, Gs^Ii, Gs^Xo, Gs^Xo, Gs, Gs^Fds, Gs^Fms, Gs^Fds, Gs^Fms, Gs^Fds, Gs^Fds, Gs^Fms, Gs^Fds, Gs, Gs^Fds, Gs^Fms, Gs^Fds, Gs^Fms, Gg^Ve, Gs^Fds, Gs^Fds, Gs^Fds, Gs
Gs^Es, Gs^Fds, Gs^Fds, Gs, Gs^Fds, Gs, Gs, Gs^Fds, Gs^Fms, Gs, Gs^Fds, Gs^Fds, Gs^Fds, Gs, Gs, Gs, Gs^Es, Gs, Gs, Gs^Fms, Gs^Fms, Gs^Fms, Gs, Gs, Gs^Efm, Gs, Gs^Efm, Gs^Fms, Gs, Gs^Es, Gs^Fds, Gs^Xo, Gg^Fet, Gs^Ii, Gs^Ii, Gs^Fms, Gs^Fds, Ww^Ewl, Ww, Ww, Ww^Ewf, Gs^Fms, Gs^Ii, Ww, Gs^Xo, Gs^Xo, Gs^Fms, Gs^Fms, Gs^Fds, Gs^Fds, Gs^Fds, Cvr, Gs^Fms, Gs^Fds, Gs^Fds, Gs, Gs^Fds, Gs^Fds, Gs^Fms, Gs^Fms, Gs^Fds, Gs^Fms, Gs^Fds, Gs^Fds, Gs^Fms, Gs, Gs^Fds
Gs^Efm, Gs^Efm, Gs^Fds, Gs^Fds, Gs^Fds, Gs^Fds, Gs^Fds, Gs, Gs, Gs, Gs, Gs, Gs^Fds, Gs^Fds, Gs^Fds, Gs^Efm, Gs, Gs^Fds, Gs^Fds, Gs^Fds, Gs^Efm, Gs^Fms, Gs^Fds, Gs^Fms, Gs, Gs^Fds, Gs, Gs^Efm, Gs^Es, Gs, Gs^Fds, Gs^Xo, Gs^Xo, Gs^Fds, Gs^Xo, Gs^Ii, Gll^Fdf, Gs^Fds, Gs^Fds, Gg, Gs^Ii, Gs^Ii, Gs^Xo, Gs^Xo, Gs^Fds, Gs^Fms, Gs^Fds, Gs^Fms, Gs^Fds, Gs^Fds, Gs^Fms, Gs^Fms, Gs^Fds, Gs^Fms, Gs^Fds, Gs^Fds, Gs^Fds, Gs, Gs^Fds, Gs, Gs^Fds, Gs^Fds, Gs^Fms, Gs, Gs^Fms, Gs^Fds, Gs
Gs, Gs, Gs, Gs, Gs, Gs^Fds, Gs^Fds, Gs^Efm, Gs, Gs, Gs, Gs^Fds, Gs, Gs^Fds, Gs^Fds, Gs^Efm, Gs, Gs^Fds, Gs, Gs^Fds, Gs, Gs, Gs, Gs, Gs, Gs^Fds, Gs^Fds, Gs, Gs, Gs, Gs^Fds, Gs^Fds, Gs^Fds, Gs^Xo, Gs^Fds, Gs^Xo, Gs^Xo, Gs^Ii, Gs^Ii, Gs^Ii, Gs^Xo, Gs^Fds, Gs^Xo, Gs^Fds, Gs, Gs^Fds, Gs, Gs^Fds, Gs, Gs^Fds, Gs^Fds, Gs^Fds, Gs^Fds, Gs, Gs, Gs, Gs^Fds, Gs^Fds, Gs, Gs^Fds, Gs, Gs^Fds, Gs^Fms, Gs^Fms, Gs, Gs^Es, Gs
