Ss, Ss, Ss, Ww, Ss, Gll^Fp, Ss, Gll, Ss, Ss, Gll, Gll, Gll, Gll, Gll, Gll, Gll, Gll, Gll, Gll, Gll, Gll, Gll, Gll, Gll, Gll, Ww, Ww, Ww, Ww, Ww, Ww, Gll, Gll, Gll, Gll, Gll, Gll, Gll, Gll, Gll, Gll, Gll, Ww, Ww, Ww, Ww, Gll, Gll, Gll, Gll, Gll, Gll, Gll, Gll
Ss, Ss, Ss, Ss, Ss, Ss, Ww, Ss, Ss, Gll, Gll, Gll, Gll, Gll, Gll, Gll, Gll, Gll, Gll, Gll, Gll, Gll, Gll, Gll, Gll, Ww, Ww, Ww, Ww, Ww, Gll, Ww, Gll, Gll, Gll, Gll, Gll, Gll, Gll, Gll, Gll, Gll, Gll, Ww, Ww, Ww, Gll, Gll, Gll, Gll, Gll, Gll, Gll, Gll, Gll
Ss, Ss, Ss, Ss, Ss, Ww, Ss, Ww, Ww, Ss, Ss, Gll, Gll, Gll, Gll, Gll, Gll, Gll, Gll, Gll, Gll, Gll, Gll, Gll, Ww, Ww, Ww, Ww, Ww, Ww, Gll, Gll, Gll, Gll, Gll, Gll, Gll, Gll, Gll, Gll, Gll, Gll, Ww, Ww, Ww, Ww, Gll, Gll, Gll, Gll, Gll, Gll, Gll, Gll, Gll
Ss, Ss, Ss, Ss, Ss, Ss, Ww, Ww, Ww, Ww, Ww, Gll, Ww, Gll, Gll, Gll, Gll, Gll, Gll, Gll, Gll, Gll, Ww, Ww, Ww, Ww, Gll, Ww, Gll, Gll, Gll, Gll, Gll, Gll, Gll, Gll, Gll, Gll, Gll, Gll, Ww, Ww, Gll, Ww, Ww, Ww, Gll, Gll, Gll, Gll, Gll, Gll, Gll, Gll, Gll
Ss, Ss, Ss, Ss, Ss, Ww, Ww, Ww, Ww, Ww, Ww, Ww, Ww, Ww, Ww, Ww, Gll, Gll, Ww, Gll, Ww, Ww, Ww, Ww, Gll, Gll, Gll, Gll, Gll, Gll, Gll, Gll, Ww, Gll, Ww, Gll, Ww, Ww, Ww, Ww, Gll, Gll, Gll, Ww, Ww, Gll, Gll, Gll, Gll, Gll, Gll, Gll, Gll, Gll, Gll
Ss, Ss, Ss, Ss, Ww, Ww, Ww, Ww, Ss, Ww, Ww, Ww, Ww, Ww, Ww, Ww, Ww, Ww, Ww, Ww, Ww, Ww, Gll, Gll, Gll, Gll, Gll, Gll, Gll, Gll, Gll, Ww, Gll, Ww, Gll, Ww, Ww, Gll, Gll, Gll, Gll, Gll, Gll, Ww, Ww, Gll, Gll, Gll, Gll, Gll, Gll, Gll, Gll, Gll, Gll
Ss, Ss, Ss, Ss, Ss, Ww, Ss, Ww, Ss, Gll, Gll, Ww, Gll, Ww, Gll, Ww, Gll, Gll, Ww, Ww, Gll, Ww, Gll, Gll, Gll, Gll, Gll, Gll, Gll, Gll, Gll, Gll, Gll, Gll, Gll, Gll, Ww, Gll, Gll, Gll, Gll, Gll, Ww, Ww, Ww, Gll, Gll, Gll, Gll, Gll, Gll, Gll, Gll, Gll, Gll
Ss, Ss, Ss, Ss, Ss, Ww, Ss, Ss, Gll, Gll, Gll, Gll, Gll, Gll, Gll, Gll, Gll, Gll, Gll, Gll, Gll, Gll, Gll, Gll, Gll, Gll, Gll, Gll, Gll, Gll, Gll, Gll, Gll, Gll, Ww, Ww, Gll, Gll, Gll, Gll, Gll, Gll, Ww, Ww, Gll, Gll, Gll, Gll, Gll, Gll, Gll, Gll, Gll, Gll, Gll
Ss, Ss, Ss, Ss, Ww, Ww, Ss, Ss, Gll, Gll, Gll, Gll, Gll, Gll, Gll, Gll, Gll, Gll, Gll, Gll, Gll, Gll, Gll, Gll, Gll, Gll, Gll, Gll, Gll, Gll, Gll, Gll, Gll, Gll, Ww, Gll, Gll, Gll, Gll, Gll, Gll, Ww, Ww, Ww, Gll, Gll, Gll, Gll, Gll, Gll, Gll, Gll, Gll, Gll, Gll
Ss, Ss, Gll, Ss, Gll, Ss, Gll, Ss, Gll, Gll, Gll, Gll, Gll, Gll, Gll, Gll, Gll, Gll, Gll, Gll, Gll, Gll, Gll, Gll, Gll, Gll, Gll, Gll, Gll, Gll, Gll, Gll, Ww, Ww, Gll, Gll, Gll, Gll, Gll, Gll, Gll, Ww, Ww, Ww, Gll, Gll, Gll, Gll, Gll, Gll, Gll, Gll, Gll, Gll, Gll
Re, Gll, Ss, Gll, Gll, Gll, Gs, Gll, Gll, Gll, Gll, Gll, Gll, Gll, Gll, Gll, Gll, Gll, Gll, Gll, Gll, Gll, Gll, Gll, Gll, Gll, Gll, Gll, Gll, Gll, Ww, Ww, Gll, Gll, Gll, Gll, Gll, Gll, Gll, Gll, Ww, Ww, Ww, Gll, Gll, Gll, Gll, Gll, Gll, Gll, Gll, Gll, Gll, Gll, Gll
Gll, Gll, Ss, Ss, Gll, Gll, Gs, Gll, Gll, Gll, Gll, Gll, Gll, Gll, Gll, Gll, Gll, Gll, Gll, Gll, Gll, Gll, Gll, Gll, Gll, Gll, Gll, Gll, Gll, Gll, Gll, Gll, Gll, Gll, Gll, Gll, Gll, Gll, Gll, Ww, Ww, Ww, Gll, Gll, Gll, Gll, Gll, Gll, Gll, Gll, Gll, Gll, Gll, Gll, Gll
Gll, Ss, Gll, Gll, Gll, Gs, Gs, Gll, Gll, Gll, Gll, Gll, Gll, Gll, Gll, Gll, Gll, Gll, Gll, Gll, Gll, Gll, Gll, Gll, Gll, Gll, Gll, Gll, Gll, Gll, Gll, Gll, Gll, Gll, Gll, Gll, Gll, Gll, Ww, Ww, Gll, Gll, Gll, Gll, Gll, Gll, Gll, Gll, Gll, Gll, Gll, Gll, Gll, Gll, Gll
Gll, Gll, Gll, Gll, Gll, Gll, Gll, Gll, Gll, Gll, Gll, Gll, Gll, Gll, Gll, Gll, Gll, Gll, Gll, Gll, Gll, Gll, Gll, Gll, Gll, Gll, Gll, Gll, Gll, Gll, Gll, Gll, Gll, Gll, Gll, Gll, Gll, Gll, Ww, Ww, Gll, Gll, Gll, Gll, Gll, Gll, Gll, Gll, Gll, Gll, Gll, Gll, Gll, Gll, Gll
Gll, Gll, Gll, Gll, Gs, Gll, Gs, Gs, Gll, Gll, Gll, Gll, Gll, Gll, Gll, Gll, Gll, Gll, Gll, Gll, Gll, Gll, Gll, Gll, Gll, Gll, Gll, Gll, Gll, Gll, Gll, Gll, Gll, Gll, Gll, Gll, Gll, Ww, Ww, Gll, Gll, Gll, Gll, Gll, Gll, Gll, Gll, Gll, Gll, Gll, Gll, Gll, Gll, Gll, Gll
Re, Gll, Gll, Gs, Gll, Gs, Gs, Gs, Gll, Gll, Gll, Gll, Gll, Gll, Gll, Gll, Gll, Gll, Gll, Gll, Gll, Gll, Gll, Gll, Gll, Gll, Gll, Gll, Gll, Gll, Gll, Gll, Gll, Gll, Gll, Gll, Gll, Ww, Ww, Gll, Gll, Gll, Gll, Gll, Gll, Gll, Gll, Gll, Gll, Gll, Gll, Gll, Gll, Gll, Gll
Gll^Fp, Gll^Es, Gll, Gs, Gs, Gll, Gll, Gll, Gll, Gll, Gll, Gll, Gll, Gll, Gll, Gll, Gll, Gll, Gll, Gll, Gll, Gll, Gll, Gll, Gll, Gll, Gll, Gll, Gll, Gll, Gll, Gll, Gll, Gll, Gll, Gll, Gll, Ww, Ww, Gll, Gll, Gll, Gll, Gll, Gll, Gll, Gll, Gll, Gll, Gll, Gll, Gll, Gll, Gll, Gll
Gll, Gll^Em, Gs, Gll, Gll, Gll, Gll, Gll, Gll, Gll, Gll, Gll, Gll, Gll, Gll, Gll, Gll, Gll, Gll, Gll, Gll, Gll, Gll, Gll, Gll, Gll, Gll, Gll, Gll, Gll, Gll, Gll, Gll, Gll, Gll, Gll, Ww, Ww, Ww, Gll, Gll, Gll, Gll, Gll, Gll, Gll, Gll, Gll, Gll, Gll, Gll, Gll, Gll, Gll, Gll
Gll, Gs, Gll, Gll, Gll, Gs, Gll, Gll, Gll, Gll, Gll, Gll, Gll, Gll, Gll, Gll, Gll, Gll, Gll, Gll, Gll, Gll, Gll, Gll, Gll, Gll, Gll, Gll, Rr, Rr, Rr, Gll, Gll, Gll, Gll, Gll, Ww, Ww, Ww, Gll, Gll, Gll, Gll, Gll, Gll, Gll, Gll, Gll, Gll, Gll, Gll, Gll, Gll, Gll, Gll
Gll, Gs, Gll, Gll, Gs, Gs, Gll, Gll, Gll, Gll, Gll, Gll, Gll, Gll, Gll, Gll, Gll, Gll, Gll, Gll, Gll, Gll, Gll, Gll, Gll, Gll, Chr, Rr, Rr, Rr, Rr, Rr, Chr, Gll, Gll, Gll, Ww, Ww, Ww, Gll, Gll, Gll, Gll, Gll, Gll, Gll, Gll, Gll, Gll, Gll, Gll, Gll, Gll, Gll, Gll
Gll, Gll, Gs, Gs, Gs, Gs, Gll, Gll, Gll, Gll, Gll, Gll, Gll, Gll, Gll, Gll, Gll, Gll, Gll, Gll, Gll, Gll, Gll, Gll, Rr, Rr, Rr, Rr, Rr, Rr, Rr, Rr, Rr, Rr, Rr, Gll, Ww, Ww, Gll, Gll, Gll, Gll, Gll, Gll, Gll, Gll, Gll, Gll, Gll, Gll, Gll, Gll, Gll, Gll, Gll
Gll, Gll, Gs, Gll, Gs, Gll, Gll, Gll, Gll, Gll, Gll, Gll, Gll, Gll, Gll, Gll, Gll, Gll, Gll, Gll, Gll, Gll, Gll, Gll^Fms, Rr, Rr, Rr, Rr, Rr, Chr, Rr, Rr, Rr, Rr, Rr, Rr, Ww, Ww, Gll, Gll, Gll, Gll, Gll, Gll, Gll, Gll, Gll, Gll, Gll, Gll, Gll, Gll, Gll, Gll, Gll
Gs, Gs, Gs, Gs, Gs, Gll, Gll, Gll, Gll, Gll, Gll, Gll, Gll, Gll, Gll, Gll, Gll, Gll, Gll, Gll, Gll, Gll, Gll, Gll^Fms, Rr, Rr, Chr, Rr, Rr, Chr, Rr, Rr, Ww, Rr, Rr, Rr, Ww, Ww, Gll, Gll, Gll, Gll, Gll, Gll, Gll, Gll, Gll, Gll, Gll, Gll, Gll, Gll, Gll, Gll, Gll
Gll, Gs, Gll, Gs, Gll, Gll, Gll, Gll, Gll, Gll, Gll, Gll, Gll, Gll, Gll, Gll, Gll, Gll, Gll, Gll, Gll, Gll, Gll, Gll^Fms, Gll^Fms, Rr, Rr, Chr, Chr, Chr, Chr, Chr, Rr, Ww, Ww, Rr, Ww, Ww, Ww, Gll, Gll, Gll, Ww, Gll, Gll, Gll, Gll, Gll, Gll, Gll, Gll, Gll, Gll, Gll, Gll
Gll, Gs, Gs, Gll, Gs, Gs, Gs, Gll, Gll, Gll, Gll, Gll, Gll, Gll, Gll, Gll, Gll, Gll, Gll, Gll, Gll, Gll, Gll, Chr, Gll^Fms, Rr, Rr, Rr, Chr, Khr, Chr, Rr, Rr, Rr, Ww, Chw, Ww, Ww, Ww, Ww, Ww, Ww, Gll, Ww, Gll, Gll, Gll, Gll, Gll, Gll, Gll, Gll, Gll, Gll, Gll
Gs, Gs, Gll, Gll, Gs, Gs, Gs, Gll, Gll, Gll, Gll, Gll, Gll, Gll, Gll, Gll, Gs^Fms, Gll, Gs^Fms, Gs^Fms, Gll, Gll, Gs^Fms, Gll^Fms, Rr, Rr, Chr, Chr, Rr, Chr, Rr, Chr, Chr, Rr, Ww, Ww, Ww, Ww, Ww, Ww, Ww, Gll, Gll, Gll, Gll, Gll, Gll, Gll, Gll, Gll, Gll, Gll, Gll, Gll, Gll
Gs, Gll, Gll, Gll, Gs, Gs, Gll, Gll, Gll, Gll, Gll, Gll, Gs^Fms, Gll, Gs^Fms, Gs^Fms, Gll, Gll, Gs^Fms, Gll, Gs^Fms, Gs^Fms, Gll^Fms, Gll^Fms, Gll^Fms, Rr, Rr, Rr, Rr, Chr, Rr, Rr, Rr, Ww, Ww, Ww, Ww, Ww, Ww, Ww, Ww, Ww, Gll, Gll, Gll, Gll, Gll, Gll, Gll, Gll, Gll, Gll, Gll, Gll, Gll
Gs, Gs, Gll, Gll, Gll, Gll, Gs, Gs, Gll, Gll, Gs^Fms, Gs^Fms, Gll, Gs^Fms, Gs^Fms, Gll, Gll, Gs^Fms, Gll, Gll, Gll, Gll, Gll^Fms, Gll^Fms, Gll^Fms, Gll^Fms, Gll^Fms, Rr, Rr, Chr, Rr, Ww, Ww, Rr, Ww, Ww, Ww, Ww, Ww, Ww, Ww, Ww, Ww, Gll, Gll, Gll, Gll, Gll, Gll, Gll, Gll, Gll, Gll, Gll, Gll
Gll, Gll, Gs, Gll, Gll, Gll, Gll, Gll, Gs, Gll, Gs^Fms, Gs^Fms, Gll, Gs^Fms, Gll, Gll, Gs^Fms, Gll, Gll, Gs^Fms, Gll, Gs^Fms, Gll, Gll^Fms, Gll^Fms, Gll^Fms, Chr, Gll^Fms, Rr, Rr, Rr, Ww, Chw, Ww, Ww, Ww, Ww, Ww, Ww, Ww, Ww, Ww, Gll, Ww, Ww, Ww, Ww, Gll, Ww, Gll, Gll, Gll, Gll, Gll, Gll
Gs, Gs, Gs, Gll, Gs, Gs, Gll, Gll, Gs^Fms, Gll, Gll, Gll, Gs^Fms, Gll, Gs^Fms, Gs^Fms, Gll, Gll, Gll, Gs^Fms, Gs^Fms, Gll, Gll, Gs^Fms, Gs^Fms, Gs^Fms, Gs^Fms, Gll^Fms, Rr, Gll^Fms, Ww, Rr, Ww, Ww, Ww, Ww, Ww, Ww, Ww, Ww, Ww, Ww, Gll, Gll, Gll, Gll, Gll, Ww, Gll, Gll, Gll, Gll, Gll, Gll, Gll
Gs^Fms, Gs^Fms, Gs, Gs, Gll^Fms, Gs, Gll, Gll, Gll, Gll, Gll, Gs^Fms, Gll, Gs^Fms, Gll, Gs^Fms, Gs^Fms, Gs^Fms, Gs^Fms, Gs^Fms, Gll^Fms, Gll^Fms, Gll, Gll, Gll, Gs^Fms, Gs^Fms, Gs^Fms, Ww, Ww, Ww, Ww, Ww, Ww, Ww, Ww, Ww, Ww, Ww, Ww, Ww, Ww, Ww, Gll, Gll, Gll, Gll, Gll, Gll, Gll, Gll, Gll, Gll, Gll, Gll
Gll^Fms, Gll^Fms, Gll, Gll^Fms, Gs, Gs^Fms, Gll, Gll, Gs, Gll, Gs^Fms, Gll, Gll, Gs^Fms, Gs^Fms, Gs^Fms, Gs^Fms, Gll, Gll, Gs^Fms, Gs^Fms, Gs^Fms, Gll^Fms, Gll, Gll, Gs^Fms, Gll, Gs^Fms, Ww, Ww, Gll, Ww, Ww, Ww, Ww, Ww, Ww, Ww, Ww, Ww, Ww, Gll, Gll, Gll, Gll, Gll, Gll, Gll, Gll, Gll, Gll, Gll, Gll, Gll, Gll
Gs^Fms, Gll^Fms, Gs, Gll, Gll, Gs^Fms, Gll, Gs, Gs, Gs, Gll, Gll, Gs^Fms, Gs^Fms, Gs^Fms, Gs^Fms, Gs^Fms, Gll, Gs^Fms, Gll, Gs^Fms, Gll^Fms, Gll^Fms, Gs^Fms, Gs^Fms, Gll, Gll, Gll, Ww, Ww, Gll, Ww, Ww, Ww, Ww, Ww, Ww, Ww, Ww, Ww, Ww, Gll, Gll, Gll, Gll, Gll, Gll, Gll, Gll, Gll, Gll, Gll, Gll, Gll, Gll
Gs, Gs^Fms, Gll, Gll, Gs, Gll, Gs^Fms, Gs, Gs^Fms, Gs, Gll, Gs^Fms, Gll, Gs^Fms, Gs^Fms, Gs^Fms, Gll, Gll, Gs^Fms, Gs^Fms, Gs^Fms, Gll^Fms, Gs^Fms, Gs^Fms, Gs^Fms, Gs^Fms, Gll^Fms, Ww, Ww, Ww, Gll, Gll, Ww, Gll, Ww, Ww, Gll, Ww, Ww, Gll, Gll, Ww, Ww, Gll, Gll, Gll, Gll, Gll, Gll, Gll, Gll, Gll, Gll, Gll, Gll
Gs, Gs^Fms, Gll^Fp, Gll, Gll, Gll, Gll, Gs^Fms, Gll^Fms, Gs^Fms, Gll, Gll, Gll, Gs^Fms, Gs^Fms, Gll, Gll, Gs^Fms, Gs^Fms, Gs^Fms, Gll, Gs^Fms, Gll, Gll, Gs^Fms, Gs^Fms, Ww, Ww, Ww, Gll, Gll, Gll, Gll, Gll, Gll, Ww, Gll, Gll, Gll, Gll, Gll, Gll, Ww, Gll, Gll, Gll, Gll, Gll, Gll, Gll, Gll, Gll, Gll, Gll, Gll
Gs, Gll^Fms, Gll^Fms, Gs^Fms, Gs^Fms, Gll, Gll, Gs^Fms, Gll^Fms, Gll, Gll, Gll, Gll, Gll, Gll, Gll, Gs^Fms, Gs^Fms, Gll, Gll, Gll, Gll, Gs^Fms, Gll, Gll, Gs^Fms, Ww, Ww, Gll, Gll, Gs^Fms, Gll, Gll, Gll, Ww, Ww, Gll, Gll, Gll, Gll, Gll, Gll, Gll, Ww, Gll, Gll, Gll, Gll, Gll, Gll, Gll, Gll, Gll, Gll, Gll
Gs, Gs^Fms, Gs, Gs^Fms, Gs^Fms, Gll, Gll, Gs, Gs^Fms, Gs, Gs^Fms, Gll, Gll, Gll, Gs^Fms, Gll, Gs^Fms, Gs^Fms, Gs^Fms, Gll, Gll, Gll, Gll, Gll, Gs^Fms, Ww, Gll, Gll, Gll, Gll, Gll, Gll, Gll, Gll, Ww, Gll, Gll, Gll, Gll, Gll, Gll, Gll, Gll, Gll, Gll, Gll, Gll, Gll, Gll, Gll, Gll, Gll, Gll, Gll, Gll
Gs, Gs^Fms, Gs, Gs, Gs^Fms, Gs^Fms, Gs, Gs, Gs, Gs, Gs, Gll, Gll, Gll, Gs^Fms, Gll, Gll, Gll, Gs^Fms, Gll, Gs^Fms, Gll, Gs^Fms, Gll, Gll, Ww, Gs^Fms, Gll, Gll, Gll, Gll, Gll, Gll, Gll, Gll, Gll, Gll, Gll, Gll, Gll, Gll, Gll, Gll, Gll, Gll, Gll, Gll, Gll, Gll, Gll, Gll, Gll, Gll, Gll, Gll
Gs^Fms, Gll, Gll, Gs, Gs^Fms, Gll, Gs^Fms, Gs, Gs^Fms, Gs^Fms, Gs, Gll, Gll, Gll, Gs^Fms, Gll, Gs^Fms, Gll, Gs^Fms, Gs^Fms, Gs^Fms, Gs^Fms, Gll, Gs^Fms, Gll, Gs^Fms, Gll, Gs^Fms, Gll, Gs^Fms, Gll, Gll, Gll, Gll, Gll, Gll, Gll, Gll, Gll, Gll, Gll, Gll, Gll, Gll, Gll, Gll, Gll, Gll, Gll, Gll, Gll, Gll, Gll, Gll, Gll
Gll, Gll, Gll, Gs^Fms, Gll^Fms, Gs, Gs^Fms, Gs^Fms, Gs, Gs^Fms, Gs, Gs, Gll, Gll, Gll, Gs^Fms, Gll, Gs^Fms, Gs^Fms, Gll, Gs^Fms, Gs^Fms, Gs^Fms, Gll, Gs^Fms, Gs^Fms, Gll, Gs^Fms, Gs^Fms, Gs^Fms, Gll, Gs^Fms, Gs^Fms, Gll, Gs^Fms, Gll, Gll, Gll, Gll, Gll, Gll, Gll, Gll, Gll, Gll, Gll, Gll, Gll, Gll, Gll, Gll, Gll, Gll, Gll, Gll
Gs, Gll, Gll^Fms, Gll^Fms, Gll^Fms, Gll^Fms, Gs, Gs, Gs, Gs, Gs, Gs, Gs, Gll, Gll, Gll, Gs^Fms, Gs^Fms, Gs^Fms, Gll, Gs^Fms, Gs^Fms, Gs^Fms, Gll, Gs^Fms, Gll, Gll, Gll, Gll, Gll, Gll, Gll, Gll, Gll, Gs^Fms, Gll, Gll, Gll, Gll, Gll, Gll, Gll, Gll, Gll, Gll, Gll, Gll, Gll, Gll, Gll, Gll, Gll, Gll, Gll, Gll
Gs, Gll, Gll, Gll^Fms, Gs, Gs^Fms, Gll, Gll, Gll, Gs, Gs^Fms, Gll^Fms, Gll^Fms, Gs, Gll, Gll, Gll, Gll, Gll, Gll, Gs^Fms, Gll, Gs^Fms, Gll, Gs^Fms, Gs^Fms, Gll, Gll, Gll, Gll, Gs^Fms, Gll, Gs^Fms, Gs^Fms, Gs^Fms, Gll, Gll, Gll, Gll, Gll, Gll, Gll, Gll, Gll, Gll, Gll, Gll, Gll, Gll, Gll, Gll, Gll, Gll, Gll, Gll
Gs, Gs^Fms, Gs^Fms, Gs^Fms, Gs^Fms, Gs^Fms, Gll, Gll, Gll, Gs^Fms, Gll, Gs, Gs, Gll^Fms, Gs, Gll, Gll, Gll, Gll, Gll, Gs^Fms, Gs^Fms, Gs^Fms, Gs^Fms, Gll, Gll, Gll, Gs^Fms, Gs^Fms, Gs^Fms, Gll, Gll, Gll, Gs^Fms, Gs^Fms, Gll, Gs^Fms, Gll, Gll, Gll, Gll, Gll, Gll, Gll, Gll, Gll, Gll, Gll, Gll, Gll, Gll, Gll, Gll, Gll, Gll
Gs^Fms, Gs^Fms, Gll^Fdw, Gs^Fms, Gll^Fms, Gll^Fms, Gll, Gs, Gll, Gll, Gll, Gll, Gll, Gs, Gll, Gs, Gs^Fms, Gll, Gll, Gs^Fms, Gs^Fms, Gll, Gs^Fms, Gll, Gs^Fms, Gs^Fms, Gs^Fms, Gs^Fms, Gs^Fms, Gll, Gll, Gll, Gs^Fms, Gs^Fms, Gll, Gs^Fms, Gs^Fms, Gs^Fms, Gll, Gll, Gll, Gll, Gll, Gll, Gll, Gll, Gll, Gll, Gll, Gll, Gll, Gll, Gll, Gll, Gll
Gll^Fdw, Gs^Fms, Gll^Fms, Gll^Fms, Gs^Fms, Gll^Fms, Gll^Fms, Gll, Gll, Gll, Gll, Gll, Gll, Gll, Gll, Gll, Gs, Gs, Gs, Gll, Gll, Gll, Gs^Fms, Gll, Gll, Gll, Gs^Fms, Gll, Gs^Fms, Gs^Fms, Gll, Gll, Gs^Fms, Gll, Gs^Fms, Gll, Gll, Gll, Gll, Gll, Gll, Gll, Gll, Gll, Gll, Gll, Gll, Gll, Gll, Gll, Gll, Gll, Gll, Gll, Gll
Gll^Fdw, Gs^Fds, Gll^Fms, Gll^Fms, Gs^Efm, Gll^Fms, Gll^Fms, Gll, Gs, Gs^Fms, Gll, Gll, Gs^Fms, Gs, Gll, Gll, Gll, Gs, Gs^Fms, Gs, Gs, Gll, Gll, Gs^Fms, Gll, Gll, Gll, Gll, Gll, Gll, Gll, Gll, Gll, Gs^Fms, Gll, Gs^Fms, Gll, Gs^Fms, Gll, Gll, Gll, Gll, Gll, Gll, Gll, Gll, Gll, Gll, Gll, Gll, Gll, Gll, Gll, Gll, Gll
Gs, Gs^Fms, Gs^Fms, Gs, Gs^Efm, Gs^Efm, Gll, Gll, Gs^Fms, Gs^Fms, Gll, Gs^Fms, Gs^Fms, Gs^Fms, Gs^Fms, Gll, Gs^Fms, Gll, Gll, Gs^Fms, Gs^Fms, Gs, Gs, Gll, Gs^Fms, Gs^Fms, Gs, Gll, Gs^Fms, Gll, Gll, Gll, Gll, Gs^Fms, Gs, Gll, Gll, Gs^Fms, Gll, Gs^Fms, Gs^Fms, Gll, Gll, Gll, Gll, Gll, Gll, Gll, Gll, Gll, Gll, Gll, Gll, Gll, Gll
Gs, Gs^Fms, Gs^Fds, Gs^Fds, Gs^Efm, Gs, Gs^Fms, Gs^Fms, Gs^Fms, Gs, Gs^Fms, Gs^Fms, Gs^Fms, Gs, Gs, Gs^Fms, Gs^Fms, Gs, Gs^Fms, Gll, Gs^Fms, Gs, Gs, Gs, Gs, Gs^Fms, Gs, Gs^Fms, Gs, Gs^Fms, Gs^Fms, Gs^Fms, Gs^Fms, Gs^Fms, Gs^Fms, Gs^Fms, Gs^Fms, Gs^Fms, Gll, Gll, Gs^Fms, Gll, Gll, Gll, Gll, Gll, Gll, Gll, Gll, Gll, Gll, Gll, Gll, Gll, Gll
Gs^Fms, Gs^Fms, Gs^Fds, Gs^Fds, Gs^Fds, Gs^Fms, Gs^Fms, Gs, Gs^Fms, Gs, Gs^Fms, Gs, Gs^Fms, Gs^Fms, Gs^Fms, Gs^Fms, Gs^Fms, Gs^Fms, Gs^Fms, Gs^Fms, Gs^Fms, Gs^Fms, Gs^Fms, Gs, Gs^Fms, Gs, Gs^Fms, Gs^Fms, Gs^Fms, Gs^Fms, Gs^Fms, Gs, Gs^Fms, Gs^Fms, Gs^Fms, Gs, Gs, Gs^Fms, Gs^Fms, Gs^Fms, Gll, Gll, Gll, Gll, Gll, Gll, Gll, Gll, Gll, Gll, Gll, Gll, Gll, Gll, Gll
Gs^Fms, Gs^Fds, Gs^Fds, Gs^Fms, Gs, Gs, Gs, Gs^Fms, Gs, Gs, Gs, Gs^Fms, Gs, Gs, Gs, Gs, Gs, Gs, Gs, Gll, Gs, Gs^Fms, Gs^Fms, Gs^Fms, Gs, Gs^Fms, Gs, Gs^Fms, Gs, Gs^Fms, Gs, Gs, Gs, Gs, Gs^Fms, Gs^Fms, Gs, Gs^Fms, Gll, Gll, Gll, Gll, Gll, Gll, Gll, Gll, Gll, Gll, Gll, Gll, Gll, Gll, Gll, Gll, Gll
