Sm, Sm, Sm, Gll, Md, Md^Xm, Md^Xm, Md^Xm, Md^Xm, Md^Xm, Md^Xm, Md^Xm, Md^Xm, Md^Xm, Md^Xm, Md^Xm, Md^Xm, Md^Xm, Md^Xm, Md, Md, Md, Md, Md, Md, Md, Md, Md, Mdd^Xm, Mdd^Xm, Hd, Hd, Qlf, Qlf, Qlf, Hd, Mdd, Mdd, Mdd, Mdd, Mv, Mdd, Mv, Mdd, Mdd, Mdd, Mdd, Mdd, Mdd, Mdd, Mdd, Mdd, Mdd, Mdd, Mdd, Mdd, Mdd^Xm, Mdd, Mdd^Xm, Mdd, Mdd, Mdd, Mdd, Hhd, Mdd, Hhd, Mdd, Hhd, Mdd, Mdd, Mdd, Mdd, Mdd, Mdd, Mdd, Mdd, Mdd, Mdd, Mdd, Hhd, Mdd, Mdd, Mdd, Hhd, Hhd, Hhd, Hhd, Mdd, Mdd, Mdd, Hhd, Hhd, Hhd, Mdd, Md, Md, Hhd, Md, Md, Md, Md, Hhd
Ss, Ss, Md^Xm, Md^Xm, Md^Xm, Md^Xm, Md^Xm, Md^Xm, Md, Re^Es, Re, Md^Xm, Md^Xm, Md^Xm, Md^Xm, Hhd, Gd, Gd, Gd, Gd^Es, Gd, Md, Md, Md, Md, Md, Md, Md, Mdd^Xm, Mdd, Mdd, Hd, Qlf, Qlf, Rr^Vd, Qlf, Mdd, Mdd, Mdd, Mdd, Mdd^Xm, Mdd, Mdd, Mdd, Mv, Wwt, Mv, Mdd, Wwt, Mdd, Wwt, Mdd, Mv, Wwt, Mdd^Xm, Mdd, Mdd, Mdd^Xm, Mdd, Mdd, Hhd, Hhd^Es, Hhd, Hhd, Hhd^Edb, Mdd, Hhd, Mdd, Hhd^Edb, Hhd, Hhd, Mdd, Mdd, Mdd, Hhd, Hhd^Es, Rd, Hhd, Rd, Hhd, Hhd, Hhd, Hhd, Mdd, Hhd, Hhd, Hhd, Mdd, Hhd, Hhd, Mdd, Mdd, Hhd^Es, Mv, Mdd, Hhd, Mdd, Hhd, Gd, Mdd^Xo, Mdd^Xo, Md
Md^Xm, Ss, Md^Xm, Md, Md, Md^Xm, Md^Xm, Md^Xm, Md^Xm, Re, Md^Xm, Re, Re, Md^Xm, Gd, Gd, Md, Md, Md, Md, Md, Re, Re, Md, Md, Md, Md, Mdd, Mdd, Mdd^Xm, Mdd^Xm, Mdd, Mdd, Qlf, Qlf, Ds, Qlf, Mdd, Mdd, Mdd, Rd, Mdd, Mdd, Qlf, Qlf, Mdd, Rd^Ebn, Mdd, Rd, Mdd, Mv, Mdd, Mdd, Hhd, Mdd, Mdd^Xm, Mdd^Xm, Mdd, Gll^Edb, Hhd, Rd, Rd, Rd, Gd, Rd, Rd, Mdd, Hhd, Rd, Rd, Rd, Mdd, Mdd, Hhd, Rd, Rd, Mdd, Rd, Gd, Rd, Rd, Gd^Vo, Rd, Rd, Rd, Hhd, Rd, Hhd, Rd, Rd, Rd, Mdd, Gd, Mdd, Hhd, Gd, Rd, Gd, Rd, Gll, Mdd^Xo, Mdd
Md^Xm, Md^Xm, Md, Md, Md, Md, Md, Md^Xm, Gll^Fdw, Gll, Gll, Md^Xm, Md^Xm, Re, Gd, Md, Md, Gll^Fdw, Md, Md, Re, Re, Hhd, Re, Re, Md, Mdd, Mdd, Mdd, Mdd, Mdd, Mdd^Xm, Mdd, Mdd^Xm, Mdd^Xm, Qlf, Mdd, Mdd^Xm, Mdd, Rd, Rd, Rd, Rd, Mdd^Xm, Rd, Qlf, Rd, Rd, Rd, Rd, Rd, Rd, Rd, Rr^Vd, Hhd, Mdd, Mdd^Xm, Mdd, Hhd^Edb, Rd, Rd, Mdd, Hhd, Gll^Edb, Rd, Gd^Es, Rd, Rd, Rd, Hhd^Edb, Mdd, Hhd, Gd, Gd^Edb, Rd, Mdd, Mdd, Mdd, Mdd, Gd, Gd, Rd, Mdd, Gd, Gd, Rd, Gd, Rd, Gd^Vo, Gd^Es, Gd, Rd, Rd, Rd, Rd, Rd, Mdd, Rd, Mdd^Xo, Gd^Vo, Md^Xo, Mdd
Md^Xm, Md^Xm, Mm, Md, Rb, Md, Md, Md^Xm, Md^Xm, Gd^Es, Gd, Gll^Fdw, Md^Xm, Gd, Hhd, Hhd^Es, Gll^Fdw, Md, Hhd, Re, Hhd, Hhd, Gll^Es, Hhd, Hhd, Re, Rd, Hhd, Hhd, Mdd, Hd, Mv, Mdd, Mdd^Xm, Mdd^Xm, Qlf, Qlf, Mdd, Mdd, Rd, Rd, Rd, Mdd, Rd, Rd, Rd, Rd, Rd, Rd, Rd, Rd, Rd, Rd, Rd, Rd, Mdd, Mdd, Mdd, Rd, Hhd, Mdd, Rd, Rd, Rd, Gd^Edb, Rd, Hhd, Mdd, Rd, Hhd^Edb, Rd, Rd, Rd, Hhd, Rd, Rd, Rd, Mdd, Mdd, Mdd, Hhd, Rd, Hhd, Hhd, Gd^Fts, Gd^Es, Gll, Rd, Hhd, Hhd, Hhd, Rd, Mdd, Gd, Mdd^Xm, Mdd^Xm, Mdd^Xm, Mdd^Xm, Mdd^Xm, Md^Xo, Md, Md
Md, Md, Md, Hhd, Gll, Rb, Hhd, Md, Md^Xm, Gll^Fdw, Md^Xm, Md^Xm, Md, Gd, Gd, Md, Hhd, Md, Hhd, Re, Hhd, Gd, Gll, Gd, Hhd, Mdd, Hhd, Rd, Rd, Hhd, Mdd, Hd, Mdd, Mdd, Mdd^Xm, Mdd, Qlf, Mdd^Xm, Mdd, Mdd, Mdd, Mdd, Qlf, Mdd^Xm, Qlf, Qlf, Rd^Ebn, Rd, Mdd, Rd, Rd, Rd, Mdd, Mdd, Mdd, Rd, Mdd, Hhd, Rd, Hhd^Edb, Rd, Rd, Gd^Edb, Mdd, Hhd, Gll, Gll, Gd, Mdd, Rd, Gll^Edb, Mdd, Hhd, Rd, Mdd, Gd, Gd^Fts, Rd, Hhd, Gd^Vo, Gd, Rd, Rd, Hhd, Gd^Fts, Wwrt, Hhd, Hhd, Mdd, Gd, Gd^Vo, Mdd, Mdd^Xo, Mdd^Xm, Mdd^Xm, Mdd, Mdd, Mdd^Xm, Md, Md, Md, Hhd
Ss, Md, Md, Hhd, Rb, Rb, Hhd, Md, Mm, Md^Xm, Md^Xm, Md^Xm, Md, Gll^Fdw, Gd, Hhd, Gll^Fdw, Md, Md, Re, Re, Gd, Gd, Gll^Fdw, Hhd, Mdd^Xm, Mdd, Mdd, Hhd, Rd, Rd, Hhd, Hhd, Mdd, Mdd^Xm, Mv, Qlf, Qlf, Qlf, Hd, Mdd^Xm, Rr^Vd, Rd, Rd, Rd, Rd, Mdd, Mdd, Mdd^Xm, Mdd, Mdd, Mdd, Mdd, Mdd, Gd, Rd, Hhd, Hhd^Edb, Mdd, Rd, Gll, Rd, Hhd, Hhd, Hhd, Mdd, Hhd, Hhd, Mdd, Hhd, Mdd, Mdd, Mdd, Hhd^Edb, Mdd, Hhd, Hhd, Wwrt, Gd^Fts, Hhd, Mdd, Gd^Es, Rd, Rd, Rd, Gd^Es, Hhd, Mdd, Mdd, Gll, Rd, Rd, Mdd^Xo, Rd, Rd, Mdd, Hhd, Mdd^Xm, Mdd^Xm, Md, Md, Md
Md, Md, Md, Hhd, Rb, Gll^Fdw, Gll^Fdw, Hhd, Md, Md, Md^Xm, Md^Xm, Md^Xm, Md, Gd, Md, Md, Md, Md, Md, Mdd, Re, Gd, Hhd, Mdd, Mdd, Mdd^Xm, Mdd^Xm, Mdd, Rd, Hhd, Rd, Rd, Mdd, Mdd^Xm, Mdd, Mdd^Xm, Qlf, Rr^Vd, Qlf, Qlf, Ds, Ds, Ds, Hd, Hd, Mdd, Mdd^Xm, Mdd, Mdd^Xm, Mdd^Xm, Mdd^Xm, Mdd, Gd^Es, Gd, Rd, Mdd, Gll, Rd, Rd, Rd, Gll, Mdd^Xm, Mdd, Mdd, Mdd, Mdd^Xm, Mdd^Xm, Mdd^Xm, Mdd^Xm, Mdd^Xm, Mdd^Xm, Mdd^Xm, Mdd, Mdd^Xm, Mdd, Mdd^Xm, Mdd, Hhd, Mdd, Mdd, Mdd, Rd, Gd, Gd^Fts, Rd, Rd, Hhd, Gll, Rd, Gd, Mdd, Mdd^Xm, Gd^Dr, Gd, Rd, Rd, Mdd^Xm, Mdd^Xm, Mdd^Xm, Mdd^Xm, Mdd^Xm
Gs, Md, Gll, Gd^Es, Gll, Rb, Mm, Md, Md, Md, Md^Xm, Md^Xm, Md^Xm, Md^Xm, Gd, Md, Md, Md, Mdd, Mdd, Gd^Es, Re, Re, Gd, Mdd, Mdd, Mdd^Xm, Mv, Rd, Rd, Mdd^Xm, Hhd, Rd, Mdd, Mdd, Mdd^Xm, Mdd^Xm, Mdd, Qlf, Qlf, Qlf, Qlf, Qlf, Ds, Qlf, Qlf, Qlf, Qlf, Qlf, Mdd, Mdd, Mdd, Mdd, Gd, Gll, Rd, Rd, Rd, Gd, Gd, Hhd, Rd, Rd, Mdd^Xm, Mdd^Xm, Mdd^Xm, Hhd, Mdd, Hhd, Hhd, Hhd, Mdd, Hhd, Mdd^Xm, Hhd, Mdd^Xm, Mdd, Mdd^Xm, Mdd^Xm, Hhd, Hhd, Rd, Gll, Mdd, Gd, Rd, Mdd, Rd, Rd, Rd, Gd^Es, Mdd, Mdd, Mdd^Xm, Mdd, Gd, Rd, Md, Md, Mdd^Xm, Mdd^Xm, Mdd^Xm
Rb, Gll^Fdw, Rb, Gll, Rb, Rb, Re, Gll^Fmw, Mm, Hhd, Mm, Hhd, Mm, Md^Xm, Md^Xm, Gd, Gd, Mdd, Mdd, Mdd, Mdd, Gd, Gd, Re, Re, Mdd, Mdd, Mdd^Xm, Mdd^Xm, Mdd^Xm, Mdd^Xm, Hhd, Rd, Mdd, Mdd, Mdd^Xm, Mdd^Xm, Mdd^Xm, Hhd, Qlf, Rr^Vd, Qlf, Mdd, Qlf, Qlf, Qlf, Qlf, Qlf, Qlf, Qlf, Qlf, Mdd, Mdd, Mdd, Mdd, Gd, Gd, Gd, Hhd, Hhd, Mdd, Rd, Mdd, Gd, Gd, Hhd, Gd, Gll^Fdw, Gd, Hhd, Gd, Hhd, Gd, Hhd, Gd, Hhd, Gd^Es, Hhd, Mdd^Xm, Mdd^Xm, Gd^Vo, Rd, Mdd, Gd^Fts, Hhd, Rd, Mdd, Mdd, Rd, Hhd, Gd, Hhd, Gd^Fts, Mdd^Xm, Mdd, Gd^Es, Gd, Rd, Md, Md, Md, Mdd^Xm
Gll^Fdw, Rb, Gll^Fdw, Rb, Gll, Gll^Fdw, Gll^Fp, Re, Re, Gs, Re, Mm, Mm, Mm, Md^Xm, Md^Xm, Gd, Mdd, Mdd, Mdd, Mdd, Mdd, Mdd, Gd, Gll, Re, Gll^Fdw, Hhd, Mdd, Mdd, Mdd^Xm, Hhd, Rd, Mdd, Mdd^Xm, Mdd^Xm, Mdd^Xm, Mdd^Xm, Mdd, Mdd, Mv, Mdd, Mdd, Mdd, Mdd, Mdd, Hd, Mdd, Hd, Qlf, Qlf, Qlf, Qlf, Mdd, Ds, Gd^Edb, Hhd, Hhd, Gd^Fts, Gll, Gd^Es, Rd, Gd, Gd^Edb, Hhd, Gd, Gd^Es, Gd, Gd, Gd, Hhd, Gd, Gll, Gll, Gll, Gd, Gd, Hhd, Hhd, Mdd^Xm, Mdd^Xm, Rd, Mdd, Rd, Rd, Rd, Rd, Mdd, Hhd, Mdd, Gd^Vo, Gd, Wwrt, Mdd^Xm, Mdd, Mdd, Gd, Rd, Hhd, Mdd, Gs^Es, Md
Gll^Fmw, Gll^Fdw, Hhd, Gll, Gll^Fp, Gs, Hh, Hh, Hh, Re, Mm, Re, Mm, Mm, Mm, Md^Xm, Md^Xm, Gd, Gd, Mdd, Mdd, Mdd, Mdd, Mdd, Mdd, Re, Re, Hhd, Mdd, Mdd, Mdd^Xm, Mdd^Xm, Rd, Mdd, Mdd^Xm, Mdd^Xm, Mdd^Xm, Mdd, Mdd^Xm, Mdd^Xm, Mdd^Xm, Mdd^Xm, Mdd, Mdd, Wwrt, Mdd, Mdd, Dd, Ds, Mdd, Dd, Qlf, Qlf, Dd, Dd, Ds, Mdd, Mdd, Wwrt, Gll, Gd, Rd, Mdd, Mdd, Mdd, Gd, Gd, Hhd, Mdd, Mdd, Mdd, Mdd, Mdd, Mdd, Mdd, Hhd, Gd, Gll, Gll^Fdw, Mdd^Xm, Mdd, Mdd, Rd, Mdd, Hhd, Gd, Rd, Mdd, Mdd, Mdd, Mdd, Gd, Gd^Fts, Mdd^Xm, Mdd^Xo, Gd^Dr, Rd, Rd, Mdd, Gd, Gd, Gll
Hh, Mm, Hh, Gs, Gll^Fp, Hh, Re, Re, Re, Mm, Re, Re, Mm, Mm, Mm, Md^Xm, Md^Xm, Md, Gd, Hhd, Hhd, Mdd, Hhd, Mdd, Mdd, Mdd, Re, Re, Mdd, Mdd, Mdd^Xm, Mdd^Xm, Rd, Mdd, Mdd^Xm, Mdd^Xm, Mdd^Xm, Mdd^Xm, Mv, Rd, Rd, Hhd^Es, Gd^Fts, Gd^Fts, Gll, Gd^Es, Hhd, Mdd, Ds, Ds, Ds, Qlf, Qlf, Mdd, Mdd, Ds, Ds, Mdd, Mdd, Gd^Fts, Mdd, Rd, Rd, Mdd, Gd, Gd, Gd, Mdd, Hhd, Hhd, Gd, Hhd^Es, Gd^Fts, Wwrt^Ii, Mdd, Hhd, Gd, Gd, Hhd, Mdd^Xm, Mdd^Xm, Mdd^Xm, Mdd, Rd, Rd, Rd, Gll, Rd, Rd, Mdd, Mdd, Mdd, Mdd^Xm, Mdd^Xm, Rd, Mdd^Xo, Mdd^Xo, Hhd, Gd, Hhd, Gs, Gll
Mm, Mm, Gll^Fmw, Mm, Mm, Mm, Re, Mm, Mm, Re, Mm, Gll^Fp, Mm, Mm, Mm, Md^Xm, Md^Xm, Md, Gll^Fdw, Gd, Gd, Gd, Gd, Hhd, Gll, Re, Re, Mdd, Hhd, Mdd, Md^Xm, Mdd^Xm, Rd, Mdd, Mdd, Mdd^Xm, Mdd^Xm, Mdd^Xm, Mdd, Hhd, Rd, Mdd, Gd, Gll, Gd^Fts, Gd, Gd, Gll^Fdw, Rd, Rd, Ds, Qlf, Qlf, Qlf, Qlf, Mdd, Ds, Ds, Ds, Mdd, Ds, Gd, Rd, Gd^Fts, Hhd, Gd^Es, Gd, Gd^Es, Gd, Gd, Gll^Fdw, Gd, Qlf, Qlf, Mdd, Mdd, Gd, Gd, Hhd, Mdd, Mdd^Xm, Mv, Mdd, Mdd, Rd, Hhd, Gd^Fts, Mdd, Rd, Mdd, Gd, Mdd, Rd, Rd, Mdd, Gd, Mdd^Xm, Mdd, Mdd, Gd, Gd, Gd
Mm, Mm, Gll^Fmw, Hh, Gd^Es, Mm, Mm, Re, Re, Hh, Mm, Mm, Mm, Mm, Md^Xm, Md^Xm, Md^Xm, Md, Hhd, Gd^Es, Hhd, Hhd, Gd, Gll, Re, Re, Gll, Gs, Hhd, Hhd, Mdd, Mdd^Xm, Rd, Rd, Mdd, Mdd, Mdd, Mdd, Mdd, Mdd^Xm, Rd, Rd, Rd, Rd, Rd, Rd, Rd, Rd, Gd, Gd, Gd, Ds, Hhd, Qlf, Qlf, Qlf, Qlf, Ds, Ds, Rd, Rd, Rd, Ds, Ds, Hhd, Hhd, Gd, Gd, Qlf, Qlf, Qlf, Qlf, Qlf, Mdd, Hhd, Mdd, Gd, Gd, Mdd, Mdd, Mdd^Xm, Uu, Mdd, Mdd, Rd, Gd, Hhd, Hhd, Rd, Mdd, Rd, Rd, Mdd, Gd, Gd, Gll^Fdw, Mdd, Mdd^Xm, Mdd^Xm, Mdd, Gd^Es, Gd
Mm, Hh, Hh, Hh, Gll^Fmw, Gs, Re, Gll^Fmw, Hh, Re, Rd, Mm, Md^Xm, Md^Xm, Md^Xm, Md^Xm, Md, Md, Gs, Hhd, Gll, Gll, Re, Re, Gll^Es, Gll, Gll, Gll^Es, Gd, Hhd, Mdd, Mdd^Xm, Mdd^Xm, Rd, Rd, Mdd, Mdd, Mdd, Hhd, Rd, Rd, Rd, Rd, Gd, Gll, Gd, Gd^Fts, Hhd, Hhd, Mdd, Hhd, Gd, Gll^Fdw, Mdd, Mdd, Qlf, Qlf, Qlf, Qlf, Ds, Qlf, Ds, Qlf, Qlf, Qlf, Qlf, Qlf, Qlf, Qlf, Qlf, Qlf, Qlf, Qlf, Ds, Gll^Fdw, Gd, Gd, Gll^Fdw, Mdd, Mdd, Mdd^Xm, Wwt, Mdd, Gd^Vo, Rd, Gd, Gd, Hhd, Hhd, Mdd, Rd, Gd, Mdd, Mdd, Gd, Hhd, Hhd, Mdd, Md, Mdd^Xm, Mdd^Xm, Mdd
Mm, Mm, Hh, Gll^Fp, Re, Re, Re, Re, Re, Re, Mm, Mm, Mm, Md^Xm, Gs^Es, Hhd, Re, Gll^Fp, Re, Gll, Re, Re, Gll, Gll, Gs, Gll, Gll, Gll^Fdw, Mdd, Mdd, Mdd^Xm, Mdd^Xm, Mdd, Hhd, Rd, Rd, Rd, Mdd, Rd, Rd, Hhd, Mdd, Mdd, Gd, Gd^Fts, Gll, Gd, Hhd, Mdd, Mdd, Gd^Es, Gd, Gd, Gd^Fetd, Gll^Fdw, Hd, Hd, Qlf, Qlf, Qlf, Qlf, Qlf, Qlf, Qlf, Qlf, Qlf, Qlf, Qlf, Hd, Ds, Qlf, Qlf, Hd, Ds, Gd, Gd, Mdd, Mdd, Mdd^Xm, Mdd^Xm, Mdd, Wwrt, Gd^Es, Gd, Gd, Rd, Gd, Hhd, Rd, Rd, Gd, Mdd, Mdd, Mdd, Gll^Fmf, Gs, Gd, Md, Md, Md, Mdd, Mdd
Mm, Hhd, Hhd, Re, Gll^Fmw, Mm, Hh, Gll^Fp, Gll^Fp, Gll^Fp, Mm, Mm, Re, Hhd, Re, Re, Gll^Fp, Re, Re, Re, Hhd, Gll^Fdw, Hhd, Gll, Hhd, Gll, Hhd, Gd, Mdd, Mdd^Xm, Mdd^Xm, Mdd^Xm, Qlf, Mdd, Rd, Hhd, Hhd, Rd, Hhd, Hhd, Mdd, Mdd, Mdd, Mdd, Hhd, Hhd, Gd^Fts, Gd, Mdd, Hhd, Gll, Gd, Gd, Gd, Gd, Gll^Fdw, Hhd, Hd, Ds, Hd, Hhd, Dd, Hd, Hd, Ds, Hd, Ds, Hd, Gll^Fdw, Ds, Ds, Hd, Gd, Gd, Gll^Fdw, Hhd, Mdd, Mdd, Mdd^Xm, Mdd, Wwrt, Wwrt, Gd^Fts, Gd, Gd, Rd, Rd, Gd^Vo, Rd, Gd, Mdd, Mdd, Mdd, Ww, Ww, Gs^Fds, Gs^Fds, Gd, Gs, Hhd, Gll^Fmf, Hh
Mm, Mm, Gll^Fmw, Re, Re, Gd^Es, Re, Hh, Hh, Hh, Gd, Gll^Fmw, Re, Re, Gd, Gll^Fp, Hhd, Hhd, Hhd, Hhd, Md, Hhd, Md, Hhd, Md, Hhd, Hhd, Hhd, Hhd, Mdd^Xm, Mdd^Xm, Mdd^Xm, Md, Rd, Mdd, Mdd, Mdd, Mdd, Mdd, Mdd, Mdd, Mdd, Mdd, Mdd, Mdd, Hhd, Mdd, Gd^Fts, Mdd, Gd^Fts, Hhd, Gll, Gll^Fdw, Gd, Gd, Gd, Gd, Gd, Gd, Hhd, Gd, Hhd, Gd, Gll^Fdw, Gd, Gd^Es, Gd^Es, Gll^Fdw, Gd, Gll^Fdw, Gd, Gd, Gd, Gd, Mdd, Mdd, Mdd^Xm, Mdd^Xm, Mdd, Wwrt, Wwrt, Gd^Fts, Gd, Gd^Es, Gd, Gd^Fts, Mdd, Rd, Hhd, Rd, Mdd, Mdd, Ww, Ww, Ww, Ww, Mdd, Gs^Es, Gs^Efm, Gd, Gd, Hh
Mm, Mm, Mm, Gll^Fmw, Gll^Fmw, Re, Gll^Fmw, Re, Re, Re, Re, Re, Hh, Hhd, Md, Md, Md, Md, Md, Md, Md, Md, Md, Md, Md, Md, Md, Md, Md, Md, Mdd^Xm, Mdd^Xm, Mdd^Xm, Md, Md, Mdd, Md, Mdd, Md, Md, Md, Md, Md, Mdd, Mdd, Mdd, Mdd, Hhd, Mdd, Hhd, Mdd, Hhd, Hhd, Hhd, Hhd, Hhd, Mdd, Hhd, Hhd, Gd^Es, Mdd, Gd, Hhd, Gd, Gll, Gll, Gll, Gd, Gll, Gd, Hhd, Gll^Fdw, Mdd, Mdd, Mdd^Xm, Mdd^Xm, Mdd, Mdd, Hhd, Gd^Es, Gd^Fts, Gd, Gd^Fts, Gd, Mdd, Mdd, Mdd, Mdd, Hhd, Mdd, Md, Md, Ww, Ww, Md, Md, Md, Md, Hh, Gs^Efm, Gs^Efm, Gs^Efm
Gll, Mm, Mm, Mm, Mm, Mm, Mm, Mm, Gll^Fmw, Gll^Fmw, Gll, Hh, Md, Md, Hhd, Md, Hhd, Md, Md, Md, Md, Md, Hhd, Md, Hhd, Md, Md, Md, Md, Mdd^Xm, Md, Mdd^Xm, Md, Mdd^Xm, Mdd^Xm, Md, Md, Md, Md, Md, Hhd, Md, Hhd, Mdd, Mdd, Mdd, Mdd, Mdd, Hhd, Mdd, Hhd, Hhd, Hhd, Hhd, Hhd, Mdd, Hhd, Mdd, Mdd, Mdd, Mdd, Mdd, Mdd, Hhd, Mdd, Mdd, Mdd, Mdd, Mdd, Mdd, Hhd, Mdd, Hhd, Mdd^Xm, Hhd, Mdd^Xm, Hhd, Mdd, Hhd, Hhd, Mdd, Hhd, Hhd, Hhd, Hhd, Hhd, Mdd, Mdd, Mdd, Md, Mdd, Ww, Gs^Fms, Ww, Ww, Md, Gs^Fms, Gs^Fms, Gs^Fms, Gs^Efm, Gs^Fms, Md
