Ww, Ww, Ww, Ww, Ss, Gll^Fp, Ss, Sm, Sm, Sm, Aa, Aa, Aa, Mm^Xm, Mm^Xm, Mm^Xm, Ms^Xm, Mm^Xm, Ms^Xm, Mm^Xm, Ms^Xm, Mm^Xm, Ms^Xm, Mm^Xm, Ha, Ha, Ai, Ai, Ai, Ai, Ai, Ai, Ha, Ha, Ms^Xm, Ms^Xm, Ms^Xm, Ms^Xm, Ms^Xm, Mm^Xm, Ms^Xm, Mm^Xm, Aa, Aa, Ai, Ai, Aa, Aa, Mm^Xm, Mm^Xm, Mm^Xm, Gll, Ms^Xm, Ms^Xm, Ms^Xm
Ss, Ww, Ww, Ss, Ss, Ss, Ww, Ss, Ss, Hh, Hh, Aa, Aa, Mm^Xm, Mm^Xm, Ms^Xm, Ms^Xm, Ms^Xm, Ms^Xm, Ms^Xm, Rb, Rb, Rb, Aa^Vla, Ha, Ai, Ai, Wo, Wo, Ai, Aa, Ai, Aa, Ha, Ms^Xm, Ms^Xm, Rb, Ha, Ms^Xm, Ms^Xm, Ms^Xm, Ms^Xm, Aa, Aa, Ai, Ai, Aa, Aa, Ha, Ha, Mm^Xm, Ms^Xm, Ms^Xm, Ms^Xm, Ms^Xm
Sm, Ww, Ss, Ss, Ss^Vhs, Ww, Ss, Ww, Ww, Ss, Ss, Aa, Hh, Aa^Vha, Aa, Mm^Xm, Ha, Ms^Xm, Ms^Xm, Rb, Ms^Xm, Ms^Xm, Ha, Rb, Wwr, Wwr, Wwr, Wo, Rb, Ai, Ai, Aa^Fda, Ms^Xm, Ms^Xm, Ms^Xm, Ha, Rb, Ms^Xm, Ha, Ms^Xm, Aa^Vea, Aa^Fpa, Aa, Aa, Wo, Ms^Xm, Aa, Ha, Ha, Mm^Xm, Mm^Xm, Mm^Xm, Ms^Xm, Ms^Xm, Ms^Xm
Sm, Ss^Vhs, Ss, Ss, Rb, Ss, Ww, Ww, Ww, Ww, Ww, Hh, Rb, Rb, Rb, Ha, Rb, Ha, Rb, Rb, Aa^Fda, Aa^Vha, Ha, Ww, Ww, Ww, Aa^Fpa, Rb, Aa^Vca, Rb, Ai, Aa^Fpa, Aa, Ms^Xm, Aa, Aa, Rb, Rb, Rb, Ai, Wo, Ai, Aa, Aa, Wo, Aa, Gll, Aa, Aa, Aa^Fda, Aa^Fpa, Mm^Xm, Mm^Xm, Ms^Xm, Mm^Xm
Sm, Ss, Rb, Rb, Ss, Ww, Ww, Ww, Ww, Aa, Aa, Ww, Wwr, Aa, Ww, Rb, Aa^Fpa, Rb, Ai, Aa^Fpa, Ww, Wo, Ww, Ww, Ha, Ha, Ha, Aa, Rb, Rb, Gll, Ai, Ww, Aa, Ai, Rb, Wo, Wo, Wwr, Wwr, Rb, Aa, Ms^Xm, Wo, Wo, Ha, Gll, Aa, Aa, Aa^Fpa, Aa, Ha, Mm^Xm, Ms^Xm, Mm^Xm
Ww, Ss, Rb, Ss, Ww, Ww, Ww, Ww, Ss, Sm, Aa, Wwr, Wwr, Wwr, Ww, Ww, Ww, Ww, Ww, Ww, Ww, Ww, Ha, Ms^Xm, Ms^Xm, Ms^Xm, Gll, Rb, Ha, Ms^Xm, Aa, Ww, Aa, Ai, Ha, Rb, Aa^Fpa, Aa, Aa, Aa, Rb, Aa, Ha, Wo, Wo, Ms^Xm, Aa, Aa, Ha, Aa, Aa^Vea, Ha, Ha, Mm^Xm, Mm^Xm
Ww, Ww, Rb, Ss, Ss, Ww, Ss, Ww, Ss, Hh, Hh, Aa, Hh, Ww, Hh, Ww, Gll, Aa^Fpa, Ww, Ww, Gll, Ww, Ha, Ms^Xm, Ha, Ha, Rb, Rb, Ms^Xm, Ms^Xm, Ha, Aa, Rb, Ha, Rb, Rb, Wo, Aa, Ha, Ha, Rb, Ha, Ai, Wo, Wo, Aa, Gll, Aa, Ms^Xm, Ha, Ha, Aa^Fpa, Aa, Ha, Ha
Ww, Ss, Ss^Vhs, Ss, Ss, Ww, Ss, Ss, Sm, Hh, Hh, Aa, Rb, Md, Md, Aa, Gd^Vhr, Gll, Gd, Gll, Aa, Gll, Mm^Xm, Ms^Xm, Hh, Gll, Rb, Ha, Ms^Xm, Ha, Aa, Rb, Aa, Rb, Wo, Wo, Aa, Aa, Ms^Xm, Ha, Rb, Ha, Ms^Xm, Wo, Aa, Aa, Ha, Aa, Aa, Ms^Xm, Ms^Xm, Rb, Ms^Xm, Ms^Xm, Mm^Xm
Ww, Ss, Ss, Ss, Ww, Ww, Sm, Sm, Sm, Md, Gll^Fmf, Rb, Rb, Gll^Fmf, Gll^Fp, Gll^Fmf, Hh, Gd, Ha, Gd, Gd, Gll, Gll^Fp, Mm^Xm, Gll, Gll, Rb, Ms^Xm, Gll, Gll, Rb, Rb, Hh, Ai, Aa, Aa, Aa, Ms^Xm, Gll, Ha, Rb, Wwr, Wo, Wo, Ms^Xm, Aa, Ms^Xm, Aa, Aa, Ms^Xm, Ms^Xm, Rb, Ms^Xm, Ms^Xm, Mm^Xm
Ss, Ww, Ww, Sm, Md, Gll^Fmf, Gs^Vht, Md, Md, Md, Rd, Rb, Hh, Gll^Fp, Aa, Hh, Gll^Fmw, Hh, Gll, Aa, Gll^Fmf, Gd, Gd, Gll^Fp, Aa, Aa, Aa, Rb, Rb, Rb, Aa, Ha, Ww, Ww, Aa, Aa, Ms^Xm, Aa, Aa, Aa, Ms^Xm, Wwr, Ww, Ww, Gll, Aa, Ms^Xm, Ha, Aa, Ha, Ms^Xm, Rb, Aa^Fpa, Ms^Xm, Mm^Xm
Mdd, Mdd, Mdd, Hhd, Hhd, Hhd, Hhd, Hhd, Md, Rd, Gll^Em, Gll^Fmf, Gll^Fmf, Gll^Fp, Hh, Gll^Fp, Gll, Gll^Fmf, Gll, Aa, Gd, Gd, Aa, Gd, Gd^Vhr, Aa^Fpa, Ha, Aa, Hh, Aa, Ww, Ww, Gll, Gll, Hh, Mm^Xm, Mm^Xm, Rrc^Vhca, Rb, Rb, Wwr, Wwr, Wwr, Gll, Aa, Aa, Ms^Xm, Ha, Aa, Hh, Mm^Xm, Re, Aa^Fda, Ha, Mm^Xm
Mdd, Mdd, Mdd, Mdd, Mdd, Mdd, Mdd, Mdd, Hhd, Rd, Gll^Fmf, Gll^Fmf, Gll^Fmf, Gll, Gd, Gll^Fp, Gll, Aa, Gd, Gd, Gll^Fp, Hh, Aa, Gll, Mm^Xm, Mm^Xm, Mm^Xm, Mm^Xm, Mm^Xm, Gll, Aa, Gll, Gll, Gll, Hh, Mm^Xm, Rb, Rb, Gll, Ai, Wwr, Wwr, Re, Aa, Aa, Mm^Xm, Mm^Xm, Hh, Mm^Xm, Mm^Xm, Re, Re, Aa^Fpa, Mm^Xm, Mm^Xm
Mdd^Xm, Mdd^Xm, Mdd^Xm, Hhd, Hhd, Mdd, Md, Gll^Fmf, Gll^Fp, Rd^Es, Rd, Hhd, Re, Re, Re, Re, Re, Aa, Gd, Gll^Fp, Gll^Fmw, Hh, Aa, Gll^Fp, Gll^Fp, Hh, Gll, Hh, Gll^Edb, Aa, Ha, Aa^Fpa, Gll^Fmw, Gll, Re, Rb, Gll^Fmw, Gll, Ww, Ww, Gll, Aa, Re, Aa, Gll^Fp, Hh, Gll^Fp, Mm^Xm, Re, Re, Hh, Gll, Aa^Fpa, Aa^Vea, Mm^Xm
Hhd, Mv, Hhd, Hhd, Gd^Vo, Hhd, Mdd, Hhd, Gd, Gll, Rd, Re, Gd, Hhd, Hhd, Aa, Gll, Re, Re, Gll^Fp, Gll^Fp, Hh, Gll^Fmw, Gll^Fp, Gll^Fmw, Gll, Gll^Fmw, Gll, Gll, Aa^Fpa, Mm^Xm, Hh, Aa^Fpa, Gll, Re, Hh, Gll, Gll^Fmw, Ww, Ww, Gll^Fp, Aa, Hh, Re, Re, Gll^Fp, Re, Re, Gll^Fp, Hh, Hh, Aa^Fda, Ha, Mm^Xm, Mm^Xm
Hhd, Hhd, Rd, Rd, Mdd, Gd, Hhd, Hhd, Rd, Rd, Gll, Gd, Hhd, Hhd, Gll^Fp, Gll^Fp, Gll^Fmf, Gll, Re, Gll^Fp, Gll^Fmw, Gll^Fmw, Gll^Fmw, Gll, Aa, Aa, Gll, Aa, Gll^Fp, Hh, Hh, Mm^Xm, Hh, Gll^Fmw, Re, Hh, Hh, Ww, Ww, Gll, Gll, Gll, Gll^Fp, Gll, Gll^Fp, Re, Gll, Aa^Fpa, Gll^Fmw, Hh, Hh, Mm^Xm, Mm^Xm, Mm^Xm, Mm^Xm
Hhd, Gll, Rd, Mdd, Mdd, Mdd, Gd^Fts, Gd, Rd, Rd, Hhd, Hhd, Hhd, Gll^Fmf, Gll^Fp, Gll^Fmf, Gll^Fmf, Gll^Fmf, Gll^Fdw, Re, Gll^Fmw, Hh, Gll^Fdw, Gll, Gll, Gll, Hh, Gll, Gll, Gll, Hh, Mm^Xm, Mm^Xm, Gll^Fmw, Re, Gll, Hh, Ww, Ww, Aa^Fpa, Gll, Gll, Gll^Fmw, Gll^Fmw, Re, Re, Aa, Aa^Fpa, Aa^Fpa, Gll^Fp, Gll, Gll^Fp, Gll, Mm^Xm, Mm^Xm
Gll^Fp, Rd, Gd^Fts, Wot, Wot, Wot, Rd, Rd, Hhd, Gd, Mdd^Xm, Hhd, Gll^Fmf, Gll^Fmf, Gll^Fmf, Gll^Fdw, Gll^Fdw, Re, Re, Re, Re, Gll^Fdw, Re, Gll, Gll^Fdw, Gll, Gd^Fetd, Gll, Gll^Fdw, Gll, Gll, Hh, Aa, Aa^Fpa, Re, Gll, Gll, Ww, Ww, Aa, Gll^Fmw, Gll^Fmw, Re, Re, Gll^Fmw, Gd, Gll^Fp, Aa, Aa, Gll, Gll^Fp, Gll^Fmw, Gll, Mm^Xm, Mm^Xm
Gll, Rd, Gd^Edp, Wot, Wot, Wot, Gd^Fts, Rd, Hhd, Mdd, Mdd, Mdd, Gll^Fmf, Gll^Fmf, Gd, Gll^Fp, Gll^Fmw, Gll^Fdw, Gll^Fp, Gd^Vhr, Gll, Re, Gll, Re, Re, Gll^Fdw, Gll^Edb, Gll, Gll^Fdw, Aa, Gll^Fdw, Gll, Re, Aa, Gll^Fdw, Gll, Wwr, Wwr, Wwr, Gll, Re, Re, Aa^Fpa, Gll^Fmw, Gll^Fp, Gd, Gd, Gll, Gll^Fmw, Gll^Fdw, Gll, Gll^Fp, Gll^Fp, Gll, Gll
Gll, Rd, Rd, Gd^Fts, Rd, Gd^Vo, Gll, Rd, Hhd, Mv, Hhd, Hhd, Gd^Vo, Hhd, Hhd, Hhd, Gll^Es, Gll^Fmw, Gll, Aa, Gll, Re, Gll^Fdw, Gll^Fdw, Re, Gll, Gll, Gll, Chr, Chr, Chr, Re, Gll, Gll^Fdw, Gll^Fdw, Gll^Fdw, Wwr, Qxe, Wwr, Re, Gll, Gll, Gll^Fmw, Gll^Fmw, Gll, Gll^Fmw, Gll^Fp, Gd^Vhr, Gll^Fmw, Gll^Fmw, Aa, Aa, Gll^Fmw, Gll, Gll
Hhd, Hhd, Hhd, Rd, Hhd, Gd^Es, Gd, Rd, Hhd, Hhd, Gd^Fts, Rd, Rd, Hhd, Md, Md, Gll^Fp, Gll^Fmw, Re^Dr, Gll, Khr, Re, Gll^Fdw, Gll^Edb, Rp^Vhcr, Re, Chr^Edb, Chr, Rp^Edb, Rp^Edb, Rp, Chr, Chr^Edb, Qxe, Qxe, Gll^Fdw, Wwr, Qxe, Qxe, Gll^Fmw, Gll, Gll^Fmw, Gll^Fp, Gll^Fmw, Gll^Fp, Gll^Fp, Gll^Fmw, Gll^Fmw, Gll, Gll^Fp, Gll, Gll, Gll^Fp, Gll^Fmw, Gll
Mdd, Mdd, Mdd, Rd, Gd^Fts, Gs, Gd, Rd, Gd^Edp, Gd^Es, Rd, Gd, Hhd, Md, Gll, Hhd, Hhd, Gll, Re^Dr, Gll, Re, Gll, Gll^Fdw, Gll, Rp, Rp, Rp, Rp, Rr, Rp, Rp^Edt, Rp, Rp, Rp, Rp, Rp^Vhcr, Ww, Chw^Edb, Qxe, Aa, Qxe, Gll^Fmw, Gll, Gll^Fmw, Gll^Fp, Gll^Fmf, Gll, Gll^Fmw, Gll, Gll^Fp, Gll^Fp, Gll^Fdw, Gll^Fdw, Gll^Fp, Gll
Rd, Mdd, Mdd, Rd, Rd, Rd, Rd, Rd, Rd, Rd, Gd, Rd, Rd, Gll, Rd, Hhd, Gll^Fmf, Re^Dr, Gll^Fmw, Gll, Re, Gll^Fdw, Re, Gll^Dr, Rr^Edt, Rp^Edt, Rr, Rp^Vhcr, Qxe, Chr^Edb, Rr, Rp^Vhcr, Rp^Edb, Rp^Edb, Rp, Rr, Ww, Ww, Gll, Qxe, Qxe, Chw^Edb, Gll^Fmw, Gll^Fp, Gll^Fp, Gll, Gll, Gll^Fmf, Gll^Fp, Gll, Gll^Fp, Gll^Fp, Gll, Gll^Fp, Gll
Gs, Rd, Rd, Rd, Gd^Edp, Rd, Rd, Gd, Md, Rd^Es, Hhd, Hhd, Hhd, Rd, Gll^Fmf, Rd, Rd, Chr, Re^Dr, Gll^Fdw, Re, Re, Re, Re, Rr, Rp, Chr, Rr, Rp, Chr, Rr, Rr^Edt, Ww, Rr, Rr, Rp, Ww, Ww, Qxe, Qxe, Gll, Qxe, Gll^Fp, Gll, Gll, Gll^Fp, Gll, Gll^Fp, Gll, Gll, Gll, Gll^Fp, Gll, Gll^Fmf, Gll
Gll, Wot, Gd^Fts, Gd, Gd, Gd, Rd, Hhd, Hhd, Rd, Mdd, Mdd, Mdd, Hhd, Gd, Re^Dr, Hhd, Re, Gll, Re, Gll, Re, Gll, Chr^Edb, Re, Rr^Edt, Rp, Chr, Chr, Chr, Chr, Chr, Rr, Qxua^Xo, Ww, Rp, Ww, Qxe, Qxe, Gll^Edb, Gll, Gll, Ww, Ww, Ww, Gll, Gd^Fetd, Gll, Chw^Edb, Gll^Fp, Gll, Gll^Fp, Gll, Gll, Gll
Gd, Md, Hhd, Hhd, Hhd, Rd, Rd, Gd^Fts, Wot, Rd, Gd^Vo, Mdd, Hhd, Gll^Fmw, Hhd, Gll^Fdw, Gll, Chr, Gll, Gll^Fdw, Gll^Edb, Gll^Fdw, Re, Chr^Edb, Gll^Fdw, Rp, Rp, Rp, Chr, 3 Khr, Chr, Rr, Rr, Qxua^Xo, Qxua^Xo, Chw^Edb, Ww, Ww, Ww, Qxe, Ww, Wwr, Ww, Ww, Ww, Ww, Ww, Ww, Ww, Gll^Fp, Gll^Fmf, Gll^Fp, Gll^Fp, Gll, Gd
Gs, Hhd, Gd^Vo, Gll^Es, Hhd, Rd, Rd, Gd^Fts, Mdd, Mdd, Mdd, Hhd, Hhd, Gd, Gll, Re^Dr, Gll^Fdw, Gll, Gll^Fmw, Hh, Re, Re, Gll^Fdw, Chr^Edb, Rp^Edt, Rp, Chr, Chr, Qxe, Chr, Rr, Chr, Chr^Edb, Rr, Ww^Bw\r, Qxua^Xo, Ww, Ww, Ww, Qxe, Ww, Ww, Ww, Qxe, Gll^Fmf, Gll, Gll^Fp, Ww, Gll, Gll^Fmf, Gll^Fmf, Gll, Gd, Gd, Gll
Gs, Rd, Rd, Gd, Gd, Rd, Gd^Edp, Mdd, Mdd, Mdd, Hhd, Hhd, Gll^Fmf, Gll, Gs^Fms, Hh, Gll, Gll^Fdw, Re, Chr^Edb, Gll^Fdw, Gll^Fmw, Gll^Fmw, Gll^Fdw, Gll^Fdw, Rr, Rr, Qxe, Rp, Chr, Rr, Qxe, Rp, Qxua^Xo, Qxua^Xo, Qxua^Xo, Qxua^Xo, Qxua^Xo, Qxua^Xo, Qxe, Ww, Ww^Vm, Ww, Ww, Gll^Fp, Gll^Fp, Gll, Gll, Gll, Gll, Gll, Gd, Gll, Gll, Gll
Gs, Gs^Edp, Gd^Edp, Gd, Rd, Rd, Rd, Mdd, Hhd, Mdd, Hhd, Gll^Fdw, Gll^Fmw, Hh, Gll^Fdw, Gll^Fmw, Gll^Fmw, Re, Gd^Fetd, Re, Re, Gll^Fdw, Gll^Fmw, Gll^Fdw, Rp^Vhcr, Rp, Rp, Rp^Vhcr, Qxua^Xo, Chr, Qxua^Xo, Rp^Vhcr, Qxua^Xo, Rr, Ur, Qxua^Xo, Qxua^Xo, Qxua^Xo, Qxua^Xo, Ww, Qxe, Ww, Ww, Ww, Gll, Gll, Gll, Gll^Dr, Gll, Gll, Gd, Gll^Fmf, Gll^Fp, Gll, Gll
Rd, Rd, Rd, Rd, Gd, Gd, Hhd^Es, Rd, Rd, Hhd, Gll^Fmf, Gll^Fmf, Hh, Gll^Fmw, Gd, Gd^Es, Gs^Fms, Re, Gll^Fmw, Gll^Fmw, Re, Gs^Fms, Gll^Edb, Gll^Fmw, Gll^Fmw, Gll^Fdw, Chr^Dr, Rp, Rp, Qxua^Xo, Rp, Qxua^Xo, Chw^Edb, Qxua^Xo, Qxua^Xo, Uue, Qxua^Xo, Qxua^Xo, Qxua^Xo, Qxua^Xo, Ww, Qxe, Gll, Wwr, Ww, Ww, Ww, Gll, Gll^Fp, Gll, Gd, Gd^Vhr, Gll^Fmf, Gll^Fmf, Gll
Mdd, Mdd, Mdd, Hhd^Es, Gd, Gs, Gd, Rd, Gll^Fmf, Hhd, Hhd, Hhd, Gll^Fmf, Gll^Fmw, Gll^Fmw, Gs^Fms, Re, Re, Gll^Fdw, Gll^Fmw, Gs^Fms, Khr, Gll^Dr, Qxe, Gll^Fmw, Gll^Fmw, Qxe, Chr, Chr, Gll^Fms, Chw^Edb, Rr, Ww^Bw\r, Qxua^Xo, Qxua^Xo, Qxua^Xo, Qxua^Xo, Qxua^Xo, Qxua^Xo, Ww^Vm, Ww, Ww, Gll, Gll, Qxe, Gll, Gll, Chw^Edb, Gll, Gll^Fmf, Gd, Gll, Gll^Fmf, Gll, Gll
Mdd, Mdd, Mdd, Hhd, Gd, Gs, Hhd, Rd, Gll, Gll, Hhd, Gll^Fmf, Gll^Fmw, Gll^Fmw, Gll, Gd^Vhr, Re, Gll^Fdw, Gll^Fdw, Gll^Fdw, Gll^Fms, Re, Re, Qxe, Gll^Fmw, Gll^Fmw, Qxe, Gll^Fmw, Ww, Chw^Edb, Qxe, Ww, Qxe, Qxua^Xo, Qxua^Xo, Qxua^Xo, Qxua^Xo, Qxua^Xo, Qxua^Xo, Ww, Wwr, Ww, Chw^Edb, Gll, Qxe, Gll, Gll^Fp, Gll, Gll, Gll, Gd, Gll^Fmf, Gll, Gll, Gll
Hhd, Mdd, Hhd, Hhd, Gd, Hhd, Gs^Vht, Rd, Rd, Gll, Gs^Fms, Hhd, Gll^Fmw, Hh, Gll^Fdw, Gll^Fmw, Gll^Fmw, Re, Re, Gll^Fdw, Gll^Fmw, Gll^Fdw, Gll^Fms, Re, Gll^Fmw, Gs^Fms, Qxe, Gll^Fmw, Ww, Ww, Qxe, Qxe, Ww, Qxe, Ww, Qxua^Xo, Ww, Qxua^Xo, Ww, Qxe, Qxe, Gll, Gll, Gll, Gd^Fetd, Qxe, Gll, Gll, Gll^Fp, Gll, Gd, Gll, Gll^Fmf, Gll, Gll
Mdd, Hhd, Gd, Gd, Gll^Fmw, Gll^Fmw, Gll, Gd, Rd, Gd, Gll, Hhd, Gs^Fms, Gll^Fdw, Gs^Fms, Gll^Fmw, Gll^Fmw, Gll^Fmw, Re, Gd, Gll^Fdw, Gll^Fdw, Gll^Fdw, Re, Re, Gll, Gll, Qxe, Wog, Wog, Ww, Ww, Ww, Qxe, Qxe, Ww, Ww^Vm, Qxe, Ww, Ww, Ww, Gll, Gll, Gll, Gll, Qxe, Gll, Gll^Fmf, Gll^Fp, Gll^Fmf, Gd, Gll^Fmf, Gll^Fmf, Gll, Gll
Hhd, Hhd, Gd, Gd, Gll^Fmw, Gll, Gs^Fms, Gs, Re, Rd, Rd, Hhd, Hhd, Gs^Fms, Hh, Hh, Gs^Fms, Gll^Fmw, Gll^Fdw, Re, Re, Gll^Fdw, Gs^Fms, Gs^Fms, Gll^Fdw, Re, Re, Wwr, Wwr, Wog, Gd, Gd, Ww, Qxe, Ww, Qxe, Wog, Qxe, Wwr, Ww, Ww, Ww, Ww, Gll, Qxe, Gll, Gll, Gll^Fp, Gll^Fmf, Gll, Gd, Gll^Fmf, Gll^Fmf, Gll^Fp, Gll
Hhd, Gll^Fmw, Gll^Fp, Gll^Fmw, Gll, Gd, Gd, Re, Gll^Fmw, Gll^Fmw, Gll^Fmw, Hhd, Gll, Gs^Fms, Gs^Fms, Hh, Gs^Fms, Gll^Fmw, Gs^Fms, Gll^Fdw, Gd, Re, Re, Gd^Vhr, Gs^Fms, Qxe, Wwr, Wwr, Wwr, Qxe, Gll^Fdw, Gll^Dr, Gd, Gd, Qxe, Qxe, Qxe, Gll, Gll, Qxe, Qxe, Ww, Ww, Qxe, Gll^Fp, Qxe, Qxe, Gll^Fmf, Gd^Vhr, Gll^Fmf, Gd, Gll^Fmf, Gll, Gll^Fmf, Gll
Hhd, Gll^Fms, Gll^Fms, Gs^Fms, Gs^Fms, Gd, Gd, Re, Re, Re, Re, Gd, Gll, Gs, Gs, Gs^Fms, Gs^Fms, Gs^Fms, Gs^Fms, Gll^Fdw, Gll^Fdw, Gll^Fmw, Gll^Fmw, Gll, Gll, Gs^Fms, Ww, Wwr, Re, Qxe, Gll^Fdw, Khr, Gll^Dr, Qxe, Ww, Wog, Qxe, Gll, Gll^Fp, Gll^Fdw, Gll, Gll, Gll, Chw^Edb, Ww, Gll, Gll^Fmf, Gll^Fp, Gd, Gd, Gll^Fp, Gll, Gll^Fp, Gll^Fmf, Gll
Gs, Gs^Fms, Gs^Es, Gs^Fms, Gs^Fms, Gll, Gd, Gd, Gs^Fms, Gd, Gs^Fms, Re, Re, Gll, Gs^Fms, Gs^Fms, Gs^Fms, Gll^Fdw, Gs^Fms, Gs^Fms, Gs^Fms, Gll^Fdw, Gll^Fmw, Gd^Es, Gll^Fdw, Chw^Edb, Gll^Fdw, Gll^Fdw, Gd^Es, Re, Gll^Fdw, Re, Gll^Fdw, Gll^Fdw, Ww, Qxe, Gll, Gll, Gd, Gd, Gll, Gll^Fp, Gll, Gll, Gll, Ww, Ww, Gll^Fmf, Gll^Fmf, Gd, Gd, Gll^Fp, Gll^Fmf, Gll^Fmf, Gll
Gs, Gs^Fms, Gs^Vc, Gs, Gs^Fms, Gs^Fms, Gd, Gd, Gs, Gd, Gs, Gll, Re, Gs, Gs^Fms, Gd, Gd, Gs^Vl, Gs^Fms, Gs^Fms, Gs^Fms, Gs^Fms, Gs^Fms, Gll^Fdw, Gll^Fdw, Ww, Ww, Gll^Fdw, Qxe, Re, Re, Re, Re, Gll^Edb, Chw^Edb, Qxe, Gd, Gll^Fp, Gs^Fms, Gd^Es, Qxe, Re, Re, Re, Re, Gll, Ww, Gll^Fmf, Gll, Gll^Fmf, Gd, Gll, Gll^Fmf, Gll^Fmf, Gll
Gs^Fms, Gd, Gll, Gs, Gs^Fms, Gll, Gs^Fms, Gs, Gs^Fms, Gs^Fms, Gs^Vc, Gd, Re, Gd, Gs, Gll^Es, Gs^Fms, Gd, Gs^Fms, Gs^Fms, Gll^Fdw, Gs^Fms, Gll^Fdw, Gs^Fms, Gll, Gs^Fms, Ww, Gs^Fms, Gll^Fdw, Gll^Fdw, Gll, Re, Gll^Fdw, Re, Re, Wwr, Re, Re, Re, Re, Gll, Gll^Fp, Gll^Fmf, Gll^Fp, Re, Gll^Fmf, Gll^Fmf, Ww, Wwr, Gll^Fmf, Gd, Gll^Fmf, Gll^Fmf, Gll^Fmf, Gll
Gll, Gd, Gd, Gs^Fms, Gll^Fms, Gs, Gs^Fms, Gs^Fms, Gs, Gs^Fms, Gs^Efm, Gs, Re, Gd, Gs^Fds, Gs^Fms, Gll, Gs^Fms, Gs^Fms, Gll, Gs^Fms, Gs^Fms, Gll^Fdw, Gll^Fdw, Gs^Fms, Gs^Fms, Wwr, Gs^Fms, Gs^Fms, Gs^Fms, Gll, Gs^Fms, Gll^Fdw, Gll, Re, Wwr, Wwr, Gd, Gd, Gd, Gll, Gd, Gll, Gd, Gd^Vhr, Re, Re, Gll^Fmf, Re, Wwr, Wwr, Gll, Ww, Ww, Ww
Gs, Gd, Gll^Fms, Gll^Fms, Gll^Fms, Gll^Fms, Gs, Gs, Gs^Efm, Gs, Gs, Gs, Re, Gs, Gd^Es, Gs, Gs^Fms, Gs^Fms, Gs^Fms, Gll, Re, Gs^Fms, Gs^Fms, Gll^Fdw, Gs^Fms, Gll, Gs, Wwr, Re, Gll^Fdw, Re, Re, Re, Re, Gs^Fms, Gd, Gd, Ww, Ww, Gs^Fms, Gs^Fms, Gll^Fp, Gs^Fms, Gll^Fp, Gll, Gll^Fmf, Re, Re, Gll^Fp, Gll^Fmf, Gll^Fp, Ww, Gll^Fmf, Gll^Fmf, Gll
Gs, Gll, Gll, Gll^Fms, Gs, Gs^Fms, Gll, Gll, Gll, Gs, Gs^Fms, Gll^Fms, Re, Gd, Gs^Fds, Gs, Gll, Gll, Re, Re, Gs^Fms, Re, Re, Gll^Fdw, Gs^Fms, Gs^Fms, Re, Wwr, Ww, Re, Gs, Gd, Gs^Fms, Gs^Fms, Gs^Fms, Gd, Gll^Fdw, Gll, Gs^Fms, Ww, Wwr, Gll, Gll, Gd, Gll, Re, Gll^Fp, Gll^Fmf, Gs^Fms, Gll^Fmf, Gll^Fmf, Gll^Fmf, Gll^Fmf, Gll^Fp, Gll^Fp
Gs, Gs^Fms, Gs^Fms, Gs^Fms, Gs^Fms, Gs^Fms, Gs^Vc, Gs, Gll, Gs^Fms, Gll^Fms, Gs, Re, Gll^Fms, Gs, Gs^Fds, Gll, Re, Gll, Gll, Gs^Fms, Gs^Fms, Gs^Fms, Re, Re, Re, Gll, Gs^Fms, Ww, Gs^Fms, Gs, Gs, Gll^Fdw, Gs^Fms, Gs^Fms, Gll, Gd, Gs^Fms, Gll, Gs^Fms, Wwr, Gll, Gs^Fms, Gll, Gll^Fp, Re, Gll^Fp, Gs^Fms, Gs^Fms, Gll^Fmf, Gll^Fp, Gll^Fmf, Gll^Fmf, Gll^Fp, Gll
Gs^Fms, Gs^Fms, Gs^Fds, Gs^Fms, Gs^Efm, Gll^Fms, Re, Gs^Es, Re, Gs, Gs, Gs, Re, Gd, Gg^Fet, Gs^Efm, Re, Re, Gg, Gs^Fms, Gs^Fms, Gs^Vl, Gs^Fms, Re, Gs^Fms, Gs^Fms, Gs^Fms, Gs, Gs, Ww, Gs, Gll, Gs^Fms, Gs^Fms, Re, Gs^Fms, Gg^Es, Gd, Gs, Wwr, Gs^Fms, Gs^Fms, Gll, Gll, Re, Re, Gs^Fms, Gll, Gll, Gll^Fp, Gll^Fmf, Gll^Fmf, Ww, Gll^Fp, Ww
Gll^Fdw, Gs, Gs^Fds, Gs^Efm, Gs^Ii, Gs^Efm, Gll^Fms, Re, Gs^Fds, Re, Re, Re, Gll, Re, Re, Re, Gs^Fds, Gs^Fds, Gs, Gll, Gs, Gll, Gs^Fms, Re, Re, Gll, Gs^Fms, Gll, Gs^Fms, Ww, Gs, Gd, Re, Re, Gs^Fms, Re, Re, Gll, Gs^Fms, Ww, Ww, Gs^Fms, Re, Re, Gs^Fms, Gll, Gll^Fp, Gll, Gs^Fms, Gll^Fp, Gs^Fms, Ww, Ww, Ww, Ww
Gll^Fdw, Gs, Gs, Gs^Efm, Gs^Efm, Gs^Efm, Gll^Fms, Gll, Gs, Gs, Gll, Gll, Gs^Fms, Gg, Gs, Gs^Fds, Gs^Fds, Gg, Gs^Fms, Gs, Gs, Gll, Gll^Es, Gs^Fms, Gg, Re, Re, Gs, Re, Wwr, Wwr, Re, Rb^Gvs, Gs^Fms, Gll, Gg, Re, Gs^Fms, Gll^Fdw, Gll^Fdw, Re, Wwr, Wwr, Gs^Fms, Gll, Gll, Gs^Fms, Gll, Gs^Fms, Gll, Gll, Ww, Gs^Fms, Ww, Gll^Fmf
Gs, Gs, Gs, Gs, 1 Gs^Ii, Gs^Efm, Gll, Gll, Gs^Fms, Gg, Gll, Gs^Fms, Gs^Fms, Gs^Fms, Gs^Fms, Gll^Es, Gg, Gll, Gll, Gs^Fms, Gs^Fms, Gs, Gs, Gs, Gg, Gs^Fms, Gs, Re, Gd, Re, Rb^Gvs, Wwr, Rb^Gvs, Gs^Fms, Gg, Gll, Re, Re, Re, Re, Gs^Fms, Re, Wwr, Gs, Gs^Fms, Gll, Gll, Gll, Gll, Gll, Gs^Fms, Gs^Fms, Gll^Fp, Gs^Fms, Gll
Gs, Gs, Gll, Gs^Fds, Gs^Efm, 2 Gs, Gs^Fms, Gs^Fms, Gs^Fms, Gg, Gs^Fms, Gs^Fms, Gs^Fms, Gs^Efm, Gs^Efm, Gs^Fms, Gs^Fms, Gs^Vl, Gd, Ww, Gs^Fms, Gs^Efm, Gs^Efm, Gg, Gs^Fms, Gs^Fms, Gs^Fms, Gs^Fms, Gs^Efm, Gs^Fms, Rb^Gvs, Wwr, Rb^Gvs, Gs^Fms, Gs^Fms, Gs^Fms, Gs^Fms, Gs^Fms, Gll, Gll, Gs^Fms, Gs^Fms, Ww, Gs^Fms, Gs^Fms, Gs, Gs^Fms, Gd, Gll, Gs^Fms, Gs^Fms, Gg^Ve, Gs^Fms, Gs^Fms, Gll
Gs^Fms, Gs^Fms, Gs^Fds, Gs^Fds, Gs^Fds, Gs^Fms, Gs^Fms, Gs^Efm, Gs^Fms, Gg, Gs^Fms, Gs^Efm, Gs^Fms, Gs^Fms, Gs^Fms, Gs^Fms, Gs^Fms, Gs^Fms, Gs^Fms, Gs^Fms, Gs^Fms, Gs^Fms, Gs^Fms, Gg, Gs^Fms, Gs^Fms, Gs^Fms, Gs^Fms, Gs^Fms, Gs^Vl, Rb^Gvs, Wwr, Gs^Fms, Gs^Fms, Gs^Fms, Gs^Efm, Gs^Efm, Gs^Fms, Gs^Fms, Gs^Fms, Gg, Gll, Ww, Gs^Fms, Gs^Fms, Gs^Fms, Gs^Fms, Gs^Fms, Gs^Fms, Gs^Fms, Gs^Fms, Gs^Fms, Gs^Fms, Gll^Fp, Gll
Gs^Fms, Gs^Fds, Gs^Fds, Gs^Fms, Gs, Gg, Gs, Gs^Fms, Gs, Gg, Gg, Gs^Fms, Gs, Gs, Gs, Gs, Gs, Gs, Gs, Gll, Gs, Gs^Fms, Gs^Fms, Gs^Fms, Gs, Gs^Fms, Gs, Gs^Fms, Gs, Gs^Fms, Gs, Wwr, Gs^Fms, Gs^Fms, Gs^Fms, Gs^Fms, Gs, Gs^Fms, Gll, Gll, Gll, Gg, Ww, Gs^Fms, Gs^Fms, Gs^Fms, Gs^Fms, Gs^Fms, Gs^Fms, Gs^Fms, Gs^Fms, Gs^Fms, Gs^Fms, Gs^Fms, Gs^Fms
